considerable|adj. 重要的；相当大的；可观的
great|adj. 伟大的；大的；极好的；adv. 很好地
large|adj. 大的
much|adv. 非常地；adj. 多；许多；pron. 许多
substantial|adj. 大量的；重大的；实质性的；坚固的
react|v. 反应
respond|v. 回答；回应；n. 回答；回应
detect|v. 察觉；查出；测出
undetected|adj. 未被发现的；未检测到的
detectable|adj. 可发觉的；可检测的；可察觉的
signal|n. 信号；标志；v. 用信号通知
alien|n. 外星人；外国人；外侨；adj. 外国的；陌生的；相异的
civilisation|n. 文明；文化
bicker|v. 斗嘴；闪烁；n. 口角
brawl|n. 争吵；打架；v. 争吵；打架
contention|n. 争论；论点；争辩
contentious|adj. 好争吵的；有争议的
controversial|adj. 有争议的
controversy|n. 争论；论战
controvert|v. 反驳；辩驳
counter|n. 柜台；对立面；v. 反驳；抵消；adv. 相反地
debatable|adj. 有争议的；有疑问的；未定的
deny|v. 否认；拒绝
disagreement|n. 分歧；争执；不一致；意见不一
disprove|v. 反驳；证明…有误
dispute|n. 纠纷；争端；v. 对（某事）有异议；争执
dissentious|adj. 好争论的；争吵的
eloquence|n. 雄辩；口才
eloquent|adj. 雄辩的；有口才的；有说服力的
gainsay|v. 否认；反驳
quarrel|v. 争吵；吵架；吵嘴；n. 争吵；口角；拌嘴
argue|v. 争论；争辩；说服；指出；表明
rebut|v. 反驳；辩驳；举反证
refute|v. 驳斥；反驳；批驳
rejoinder|n. 回答；反驳；答辩
retort|v. 反驳；回嘴；n. 反驳；顶嘴
squabble|n. 争吵；v. 争吵
tiff|n. 口角；争吵
wrangle|v. 争论；争执；吵架；n. 争吵；口角
dweller|n. 居民；居住者
evolution|n. 进化；演变；发展
extract|n. 提取物；摘录；精华；节录；v. 拔出；提取；摘录
remove|v. 搬迁；去掉；移开；消除
cull|v. 拣选；采集；挑出（老弱动物）杀死
abstract|adj. 抽象的；非具体的；深奥的；v. 提取；抽取；作…的摘要；n. 摘要；概要；抽象派艺术作品
habitable|adj. 适合居住的；可居住的
humidity|n. 湿度；湿气
inhospitable|adj. 冷淡的；不好客的；不适于居住的；荒凉的
inorganic|adj. 无机的；非自然生长的
lander|n. 登陆者；着陆器
manned space flight|phrase. 载人航天飞行
microbial|adj. 微生物的；由细菌引起的
orbiter|n. 轨道飞行器；航天飞行器
organic|adj. 有机的；器官的
planetary|adj. 行星的
primitive microbe|phrase. 原始微生物
reside in|phrase. 居住于；存在于
solar|adj. 太阳的；太阳能的
space probe|phrase. 航天探测器
spacecraft|n. 航天器；宇宙飞船
ultraviolet radiation|phrase. 紫外线辐射
ultraviolet|adj. 紫外的；紫外线的；n. 紫外线辐射；紫外光
underground water|phrase. 地下水
explore|v. 探索；勘探
ferret|n. 白鼬；雪貂；v. 用雪貂打猎；搜寻
grope|v. 摸索；搜索；搜寻
risk|n. 风险；v. 冒...的危险
seek|v. 寻求；寻找
venture|v. 冒险；投机；n. 冒险事业；商业冒险；投机
world war|phrase. 世界大战
interrupt|v. 打断；打扰；打岔
interruption|n. 中断；打岔的事
raw|adj. 生的；未加工处理过的
natural|adj. 自然的；天然的
stifle|v. （使）窒息；抑制；扼杀
silk|n. 丝绸
industry|n. 工业；产业；行业；勤奋
aggressiveness|n. 进攻性；侵略性；积极进取
aggressively|adv. 侵略地；挑衅地；有闯劲地
air war|phrase. 空战
assault|n. 攻击；袭击；侵犯他人身体（罪）；v. 袭击；突袭
battle field|phrase. 战场
besiege|v. 围困；围攻
blockade|n. 阻塞；封锁；v. 封锁
bombing|n. 轰炸；爆炸；投弹；v. 投弹于；轰炸；“bomb”的现在分词
campaign|n. 战役；运动；（政治、商业或社会性）活动；v. 参加战役；从事活动
classified|adj. 分类的；机密的；v. 分类；“classify”的过去式和过去分词
cold war|phrase. 冷战
collision|n. 碰撞；冲突
collide|v. 碰撞；相撞；冲突
combat|n. 战斗；v. 战斗；防止；抑制
combative|adj. 好斗的
confidential|adj. 机密的；秘密的；视为心腹的
conquer|v. 征服；克服
conqueror|n. 征服者；占领者
defeat|v. 击败；战胜；使受挫；n. 失败；战胜
defense|n. 辩护；防御；国防；防守
diplomacy|n. 外交；外交手腕；交际手段
diplomatic|adj. 外交的；有交际手腕儿的
disarm|v. 解除武装；缴械；裁减军备
disarmament|n. 裁减军备；解除武装；缴械
encircle|v. 包围；围绕
encroach|v. 侵入；侵占；侵犯；侵蚀
enlist|v. 参军；入伍；谋求（某人的帮助）
envelop|v. 包封；遮盖；包围
exterminate|v. 消灭；灭绝；根除
insurrection|n. 起义；叛乱
intrude|v. 闯入；打扰；强使
invade|v. 侵犯；侵略
invasion|n. 侵犯；侵略
invader|n. 侵略者
martial|adj. 战争的；军事的
onslaught|n. 猛攻；冲击；突击；大量的倾泻
outbreak|n. 爆发；发作
rebellion|n. 叛乱；反叛；造反
rebel|v. 反抗；造反；n. 叛逆者；造反者
rebellious|adj. 反叛的；叛逆的
repulse|v. 击退；回绝；憎恶；n. 拒斥；击退；严拒
repel|v. 排斥；相斥；击退；驱逐
revolt|v. 叛乱；反叛；（使）厌恶；n. 叛乱；厌恶；反感
riot|n. 骚乱；暴乱
tactic|n. 战术；策略
trespass|v. 非法侵入；侵扰；冒犯；n. 非法进入；冒犯
truce|n. 停战（协定）；休战（协定）
warfare|n. 战争；斗争
wreck|v. 破坏；毁坏；n. 遇难船只；失事；残骸
wrecking|n. 破坏（建筑物等）的行为；v. 破坏；“wreck”的现在分词
airfield|n. 飞机场
armament|n. 军备；武器；备战
cannon|n. 大炮；火炮；v. 猛撞；碰撞
fortress|n. 堡垒；要塞；防御阵地
radar|n. 雷达
weapon|n. 武器
armada|n. 舰队；西班牙无敌舰队
bellicose|adj. 好战的；好斗的
fleet|n. 舰队；船队；机群；adj. 快速的；v. 掠过；疾飞
flotilla|n. 小舰队
militant|adj. 激进的；好战的；n. 激进；好战
military|adj. 军事的；军用的；n. 军队；武装力量
morale|n. 士气；精神力量
mutiny|n. 反叛；暴动；v. 反叛；暴动
navy|n. 海军；藏蓝色的
troop|n. 军队（复）；部队（复）；连；队；群；v. 群集；结队；成群前行
migration|n. 迁移；迁徙；转移
migrate|v. 迁移；移居；迁徙
issue|n. 问题；发行（物）；重要议题；流出；v. 发行；发表；流出；在…上挑起争论
biologist|n. 生物学家
biology|n. 生物学
biological|adj.  生物学的；生物的
microbiology|n. 微生物学
define|v. 下定义；定范围
definition|n. 定义；清晰度
in part|phrase. 在某种程度上；部分地
sort|n. 种类；类别；v. 把…分类；拣选；理清；解决
bat|n. 蝙蝠；球拍；球棒；v. 击（球）
beast|n. 兽；凶残的人
beaver|n. 海狸；海狸毛皮；v. 勤奋工作
buffalo|n. 水牛；野牛
camel|n. 骆驼
chimpanzee|n. 黑猩猩
donkey|n. 驴
fauna|n. 动物群；动物区系
genus|n. （动植物的）属；类
gibbon|n. 长臂猿
giraffe|n. 长颈鹿
gorilla|n. 大猩猩
herd|n. 兽群；牧群；芸芸众生；v. 放牧；（强制）集合
herdsman|n. 牧人；牧主
hippo|n. 河马
horde|n. （熙攘、纷扰的）一大群
horn|n. 角；号角；喇叭
koala|n. 树袋熊；考拉熊；无尾熊
marmot|n. 土拨鼠
niche|n. 壁龛；合适的位置；称心的职务；商机；生态位
ox|n. 公牛；（阉割的）公牛
pony|n. 矮马；小型马；v. 付清
reindeer|n. 驯鹿
rhinoceros|n. 犀牛
seal|n. 海豹；印章；v. 密封；封上
sloth|n. 懒惰；树懒
whale|n. 鲸；v. 捕鲸
woodpecker|n. 啄木鸟
yak|n. 牦牛
zebra|n. 斑马
zoology|n. 动物学；（某一地区的）全部动物；（某种动物的）动物特性
aquatic|adj. 水生的；水栖的；水中的
carnivore|n. 食肉动物；食虫植物
carnivorous|adj. 食肉的
class|n. 班级；课；等级；阶级；类别
coelenterate|n. 腔肠动物
domestic|adj. 家庭的；国内的；驯养的；n. 佣人
domesticate|v. 驯养；使爱家；适应家庭生活
family|n. 家庭；家族；（动、植物的）科；（语言的）族、系；adj. 家庭的；家族的
habitat|n. 栖息地；居留地；产地
herbivorous|adj. 食草的
homotherm|n. 恒温动物
invertebrate|adj. 无脊椎的；无骨气的；n. 无脊椎动物；无骨气的人
vertebrate|adj. 有脊骨的（动物）；n. 脊椎动物
omnivorous|adj. 杂食的；兴趣广泛的
order|n. 顺序；条理；订单；命令；（生物学的）目；v. 订购；命令；点餐；整理
poikilotherm|n. 变温动物；冷血动物
predator|n. 掠夺者；捕食性动物；食肉动物
predatory|adj. 食肉的；掠夺性的
prey|n. 猎物；受害者；受骗者；v. 捕食；坑害；折磨
primate|n. 灵长类（动物）；大主教
quarry|n. 采石场；猎物；v. 挖出；苦心找出
rodent|n. 啮齿动物；adj. 啮齿目的
scavenger|n. 食腐动物；拾荒者
suborder|n. 亚目
chirp|v. 吱喳而鸣；欢快地高声说话；n. 喳喳声；唧唧声
dormancy|n. 休眠；冬眠；潜伏
estivation|n. 夏眠；度夏
hibernation|n. 冬眠
graze|v. 放牧；吃草；擦伤；n. 擦伤
overgraze|v. 过度放牧
gregarious|adj. 群居的；合群的；爱社交的
hatch|v. 孵出；出壳；秘密策划；n. 舱口；小窗口
leap|v. 跳跃；n. 跳跃
emigrate|v. 移居国外
immigrate|v. 移居入境
migratory|adj. 迁移的；迁徙的；移栖的
nest|n. 窝；鸟巢；（能叠放在一起的）一套物件；v. 筑巢；嵌套
peck|v. 啄；连续敲击；轻吻；n. 啄痕；啄食；轻吻
pregnant|adj. 怀孕的；妊娠的
reproduce|v. 繁殖；复制
reproduction|n. 生殖；繁殖；复制
reproductive|adj. 生殖的；再生的；复制的
spawn|n. 卵；产物；v. 产卵
squeak|n. 吱吱声；尖叫声；v. 短促而尖厉地叫；吱吱叫
way|n. 道路；方向；路线；方法；方式
backstage|adv. 在后台；私下；秘密地；adj. 幕后的；关于戏剧界人物私生活的；n. 后台；幕后
tour|n. 旅游；游览；巡回活动；v. 旅行；游览；作巡回活动
show round|phrase. 带...参观；带...转转；n. 表演
theatre|n. 剧场；电影院
operate|v. 操作；运转；施行手术
operation|n. 操作；运行；手术
operational|adj. 操作的；运作的
a tragic ending|phrase. 悲惨的结局；悲剧收场
dialogue|n. 对话；对白
drama|n. 戏剧；话剧
main plot|phrase. 主要情节
monologue|n. 独白；独角戏；长篇大论
offstage|adj. 舞台后面的；后台的；台下的；adv. 舞台后面地；后台地；幕后地
playwright|n. 剧作家
puppet|n. 木偶；傀儡
script|n. 剧本；脚本；手稿
thespian|adj. 戏剧的
black comedy|phrase. 黑色喜剧
dance drama|phrase. 舞剧；舞蹈剧
farce|n. 闹剧；胡闹；滑稽戏
modern drama|phrase. 话剧；现代戏剧
music drama|phrase. 音乐剧
musical comedy|n. 音乐喜剧
opera|n. 歌剧
pantomime|n. 哑剧；（英）圣诞童话剧；v. 打手势；演哑剧
pantomimic|adj. 哑剧的
puppet show|phrase. 木偶剧
satirical comedy|phrase. 讽刺喜剧
sentimental comedy|phrase. 言情喜剧；感伤喜剧；滥情喜剧
situation comedy|phrase. 情景喜剧
sitcom|n. 情景喜剧
tragedy|n. 悲剧；灾难；惨事
tragic|adj. 悲剧的；悲惨的；不幸的
act|v. 行动；表现；演戏；n. 行动；装模作样；（戏）幕；法令
comedian|n. 喜剧演员；滑稽人物
curtain call|n. 谢幕
funnyman|n. 喜剧演员；滑稽演员
hero|n. 英雄；男主角
heroic|adj. 英勇的；英雄的
heroine|n. 女英雄；女主角
impersonate|v. 模仿；假扮
interval|n. 间隔；中场休息
mime|n. 哑剧；默剧；哑剧动作；v. 表演哑剧；用哑剧动作表现
repertoire|n. 全部节目；全部才能
stagehand|n. 舞台工作人员；舞台管理
approach|v. 接近；靠近；临近；处理；n. 方法；接近；靠近；路径
solution|n. 解决办法；溶液
avenue|n. 大街；林荫道；途径
direct|adj. 直接的；v. 指导；指示
indirect|adj. 间接的；迂回的
fashion|n. 时尚；流行；姿态；方式；v. 制作；把...塑造成；使适应
fashionable|adj. 流行的；时髦的
forthright|adj. 直截了当的；直率的；坦白的
means|n. 手段；方法；收入；财富；v. 意思是；表示…的意思；“mean”的第三人称单数
tool|n. 工具；£具；器具；v. 用工具加工
method|n. 方法；办法
mode|n. 方式；样式；模式
pathway|n. 道路；小路；小径
procedure|n. 程序；手续；步骤
recipe|n. 食谱；烹饪法；处方；秘诀
knack|n. 技巧；诀窍
shortcut|n. 捷径；近路
tip|n. 小费；提示；窍门；建议；尖端；v. 给…小费
via|prep. 通过；经由
afraid|adj. 害怕的
happen|v. 发生
magazine|n. 杂志
disappear|v. 消失；不见
row|n. 排；划船；吵闹；v. 划船；吵架
alarm|n. 警报；警铃；闹钟；惊慌；v. 使惊恐
anxious|adj. 焦虑的；不安的；担忧的；渴望的
uneasy|adj. 不安的；不自在的；忧虑的
evaporate|v. （使）蒸发；消失
evaporation|n. 蒸发；消失；脱水；干燥
vaporize|v. （使）蒸发；（使）汽化
extinct|adj. 灭绝的；熄灭的；绝种的
extinction|n. 灭绝；消亡
fade|v. 逐渐消失；褪色；凋谢
fade-in|n. （画面等的）淡入
fade-out|n. （画面等的）淡出
linger|v. 徘徊；逗留；流连；磨蹭
vanish|v. 销声匿迹；突然消失
vanished|adj. 消失了的；v. 销声匿迹；突然消失；“vanish”的过去式和过去分词
advertising|n. 做广告；广告业；广告活动；adj. 广告的；v. 做广告；登广告；“advertise”的现在分词
anthology|n. 选集；文选
article|n. 文章；物品；项目；条款；冠词
big news|phrase. 重大新闻
bimonthly|adj. 两月一次的；每月两次的；adv. 两月一次地；每月两次地
biweekly|adj. 两周一次的；隔周的；adv. 两周一次地；隔周地；n. 双周刊
business magazine|phrase. 商业杂志
circulation|n. 循环；流通；发行量
column|n. 圆柱；专栏；纵；列
columnist|n. 专栏作家
consumer magazine|phrase. 消费者杂志；消费类杂志；消费类期刊
contributor|n. 贡献者；捐助者；投稿人；因素
distribution|n. 分布；分配
editor|n. 编辑（者）；剪辑员
editor-in-chief|n. 总编辑
encyclopedia|n. 百科全书
evening edition|phrase. 晚报
fortnightly|adj. 两星期一次的；隔周发行的；adv. 两周一次地；n. 双周刊
fortnight|n. 两星期
full-page|adj. 全页的；满版的
government organ|n. 官报
headline|n. 大字标题；头条
journal|n. 日志；日记；期刊；杂志
literary magazine|phrase. 文学杂志
low-cost|adj. 廉价的；价格便宜的；成本低的
magazine cover|n. 杂志封面
monthly|adj. 每月的；每月一次的；adv. 每月一次；每个月；n. 月刊
morning edition|phrase. 晨报
news magazine|n. 新闻杂志
newsboy|n. 报童
newspaper|n. 报纸
newsprint|n. 新闻纸；白报纸；报纸上的文字；（印刷报纸的）油墨
newssheet|n. 单张报纸；新闻传单；简报
paperback|n. 平装书；平装本
popular paper|n. 大众报纸
publication|n. 发表；公布；出版；出版物
publisher|n. 出版者；出版社；发行人
quality paper|phrase. 优质报纸；高质量报纸
quarterly|adj. 季度的；adv. 每季一次；n. 季刊
science magazine|phrase. 科学杂志
trade paper|phrase. 专业性报纸
weekly|adj. 每周的；adv. 每周；n. 周刊；周报
psychological|adj. 心理的；心理学的
psychologically|adv. 心理上地；心理学地
claim|n. 声称；索要；要求；认领；v. 声称；要求；索赔
legitimacy|n. 合法性；正统性；合理性
evoke|v. 唤起；引起
trust|n. 信任；信赖；v. 信任；信赖
counselor|n. 顾问；咨询师；法律顾问
illegal|adj. 非法的；违法的
illegality|n. 违法性；非法；非法行为
illegally|adv. 非法地；不法地
lawful|adj. 法律许可的；守法的；合法的
legal|adj. 合法的；法律的
legislation|n. 立法；法规
legislative|adj. 立法的；制定法律的；n. 立法权；立法机关
legitimate|adj. 合法的；合理的；法律认可的；v. 使合法；认为正当
legitimately|adv. 正当地；合法地；合理地
legitimise|v. 使（尤其是坏事）合法化；正式批准（或认可）
outlaw|n. 亡命之徒；逃犯；被剥夺法律权益者；v. 宣布…为非法；使…成为非法
vested|adj. 法定的；既定的；v. 授予；使穿衣；“vest”的过去式和过去分词
abnormal psychology|phrase. 变态心理学；异常心理；变态心理
criminal psychology|phrase. 犯罪心理学；犯罪心理
educational psychology|phrase. 教育心理学
group psychology|phrase. 从众心理；群体心理学；群体心理
individual psychology|phrase. 个体心理学；个体心理
personality psychology|phrase. 人格心理学；个性心理学
social psychology|phrase. 社会心理学
acrophobia|n. 恐高症；惧高症
affective|adj. 情感的
affection|n. 钟爱；喜爱
allergy|n. 过敏症；反感；厌恶
apathy|n. 冷淡；漠不关心
assertive|adj. 坚定自信的；断言的；果断的
attributable|adj. 可归因于…的；由…引起的
claustrophobia|n. 幽闭恐怖（症）
congenital|adj. 先天的；天生的；生性的
delusion|n. 错觉；妄想
deviance|n. 偏常；异常行为
deviant|adj. 不正常的；离经叛道的；n. 不正常的人
disorder|n. 混乱；无秩序；失调
disorderly|adj. 不整齐的；混乱的；骚乱的；无秩序的
emotional|adj. 感情的；情绪的
illusion|n. 错觉；幻觉
mirage|n. 海市蜃楼；幻象
innate|adj. 生来的；天生的
insane|adj. 疯狂的；精神失常的；精神错乱的
sane|adj. 心智健全的；头脑清醒的；明智的
instinct|n. 本能；直觉
mental|adj. 精神的；心理的
multiple personality|phrase. 多重人格
pathology|n. 病理学
phobia|n. 恐怖病；恐怖症
psychiatry|n. 精神病学
psychic|adj. 精神的；灵魂的；心理的；通灵的；n. 通灵的人
rational|adj. 理性的；理智的；合理的
retrospection|n. 回顾
spiritual|adj. 精神上的；心灵的
sympathy|n. 同情；慰问
symptom|n. 征兆；症状
trauma|n. 身体上的伤；精神上的创伤；外伤
abolish|v. 取消；废除；废止
accomplice|n. 帮凶；共犯；同谋
acquittal|n. 宣告无罪；无罪的判决
annul|v. 废除；取消；宣告无效
annulment|n. 取消；废除；宣布无效
arbitration|n. 仲裁；公断
bill|n. 账单；钞票；议案；v. 给…开账单
cancellation|n. 取消；撤销；作废；中止
captivity|n. 监禁；关押；困住
codification|n. 法典编纂；编码；法典化
condone|v. 宽恕；容忍；纵容（不道德行为）
confirmation|n. 证实；确认；批准
constitution|n. 宪法；制定；设立；构成；体格；体质
court|n. 法院；球场；宫廷；v. 求爱；献殷勤；招致
culprit|n. 罪犯；犯错的人
decree|n. 法令；判决；v. 判决；颁布；裁定
defendant|n. 被告人；被诉方；adj. 被告的；辩护的
denounce|v. 公开指责；告发；揭发
deposition|n. 沉积（物）；革职；宣誓证词；作证书
detain|v. 扣留；拘押；耽搁
domineering|adj. 专横的；盛气凌人的
enforcement|n. 执行；实施
exempt|adj. 被免除的；被豁免的；v. 豁免；免除
extradition|n. 引渡
eyewitness|n. 目击者；目击证人
hearing|n. 听力；听觉；v. 听；听见；“hear”的现在分词
impeach|v. 控告；弹劾；怀疑
imprison|v. 监禁；束缚
imprisonment|n. 监禁；关押；徒刑
incriminate|v. 使负罪；指控…有罪；牵连
indemnity|n. 保险；赔款；赔偿
indemnification|n. 赔偿；保障；赔偿物（或赔偿金）
interrogatory|n. 质问；讯问；adj. 质问的；疑问的
jurisprudence|n. 法学；法律学
legality|n. 合法
liability|n. 责任；义务；负债
non-observance|phrase. （对协议等的）不遵守
notary|n. 公证人；公证员
observance|n. 遵守；奉行；庆祝
patent|n. 专利；专利权；专利证书；adj. 有专利的；受专利保护的
penalty|n. 惩罚；刑罚
query|n. 询问；疑问；问号；v. 询问；怀疑
ratification|n. 批准；认可
recidivist|n. 惯犯
remit|v. 宽恕；免除；汇寄；减缓；送呈
revocation|n. 撤回；撤销；取消
substantiate|v. 证实；实体化
summons|n. 召唤；传票；召见令；v. 召唤；召集；鼓起（勇气）；“summon”的第三人称单数
testify|v. 作证；证明
accusation|n. 控告；起诉；指控
indictment|n. 起诉；控告；起诉状
lawsuit|n. 诉讼
nonsuit|n. 诉讼驳回；v. 驳回
plaintiff|n. 起诉人；原告
plea|n. 恳求；申诉；抗辩；借口
proceeding|n. 进程；事件；诉讼程序；v. 进行；继续；继续进行；“proceed”的现在分词
prosecute|v. 起诉；控告；检举；指控；继续从事
sue|v. 起诉；控告；请求
display|v. 展示；陈列；n. 展示；陈列
exhibition|n. 展览；展出
show|v. 展示；表明；给...看；n. 演出；展览会；表现
warning|n. 警示；警戒；v. 警告；告诫；“warn”的现在分词
critical|adj. 批判性的；临界的；危急的；关键的；至关重要的
uncritical|adj. 不加辨别的；不加批判的
critically|adv. 批评地；危急地；严重地
emerge|v. 浮现；显露；暴露
spontaneous|adj. 自发的；自然产生的
criticism|n. 批评；指责；评论
suppress|v. 镇压；抑制；查禁；使止住
squash|v. 把…压扁（或压坏）；（使）挤进；制止；n. 拥挤；壁球
restrain|v. 抑制；抑止
suppressant|adj. 抑制性的
suppression|n. 压制；镇压；抑制
aesthetic|adj. 审美的；美学的
ancient calligraphy and painting|phrase. 古代书画
art|n. 艺术
artistic|adj. 艺术的
artware|n. 工艺品；实用工艺美术品
bronze ware|phrase. 青铜器；铜器
cradle|n. 摇篮；发源地；吊架；v. 轻轻抱着
creative art|phrase. 创造性艺术；创意艺术
decorative art|phrase. 装饰艺术
display cabinet|phrase. 展示柜
edify|v. 启发；陶冶；启迪
edification|n. 启迪；教诲；熏陶
exhibit|v. 展览；陈列；展示；n. 展品；展览
fine art|phrase. 艺术
glassware|n. 玻璃制品
jadeware|n. 玉器
language art|phrase. 语言艺术
medium|n. 媒介；方法；adj. 中等的；适中的
performing art|phrase. 表演艺术
photography work|phrase. 摄影作品；摄影工作
plastic art|phrase. 造型艺术
porcelain|n. 瓷；瓷器
primitive art|phrase. 原始艺术
reproducibility|n. 再现性；重复能力
space art|phrase. 太空美术；空间艺术
startling|adj. 令人吃惊的；v. 使惊动；使惊愕；使吃惊；“startle”的现在分词
time and spatial art|phrase. 时空艺术
time art|phrase. 时间艺术
art museum|phrase. 美术馆；艺术博物馆
audio tour|phrase. 语音导览；语音向导
British Museum|n. 不列颠博物馆(英国¸大的综合性博物馆,在伦敦)
caption|n. 插图说明；标题；字幕；v. 加上说明；加上标题；加上字幕
dinosaur|n. 恐龙
dinosaur model|phrase. 恐龙模型
educational|adj. 教育的；有教育意义的
exhibition opening time|phrase. 展览开放时间
explain|v. 解释；说明；阐明
fossil|n. 化石；守旧的事物
ground map|phrase. 地形图
historic|adj. 有历史意义的；历史性的
incomparable|adj. 不可比拟的；无比的；无与伦比的；不能比较的
Jurassic Period|n. 侏罗纪
Louvre|n. 罗浮宫
main entrance|phrase. 主要入口；正门入口
military equipment|phrase. 军事装备；武装；军备
military museum|n. 军事博物馆
museum plan|phrase. 博物馆平面图
museum staff|phrase. 博物馆员工
National Museum of China|n. 中国国家博物馆
American Museum of Natural History|n. 美国自然历史博物馆
natural history museum|phrase. 自然历史博物馆
no flash|phrase. 请勿使用闪光灯；禁止闪光灯
on display|phrase. 陈列；展览
painting|n. 绘画；油画；v. 刷油漆；用颜料画；“paint”的现在分词
The Palace Museum|n. 故宫博物馆
precious|adj. 珍贵的；宝贵的
pterosaur|n. 翼龙
security camera|phrase. 监控摄像头
security system|phrase. 保安系统；安防系统
science museum|phrase. 科学博物馆
sculpture|n. 雕刻（术）；雕塑品；雕刻品；v. 雕塑；刻蚀
showpiece|n. 展品；样品；陈列品；典范
ticket counter|phrase. 售票柜台；售票处
tyrannosaurus|n. 暴龙
unearthly|adj. 非尘世的；怪异的；可怕的；时间过早或不便的
with access all day|phrase. 全天开放
vertical|adj. 竖的；垂直的
attempt|n. 企图；试图；v. 企图；试图
try|n. 尝试；试图；v. 尝试；试图；努力
address|n. 地址；网址；演说；v. 写上地址；向…讲话；解决
undoubted|adj. 无疑的；确实的；千真万确的
undoubtedly|adv. 无疑地
face|n. 脸；v. 面对
produce|v. 生产；生育；制造；出示；导致；引起；n. 农产品
generate|v. 产生；引起；发（热、电）
manufacture|v. （用机器大量）制造；虚构；捏造；n. 制造
barley|n. 大麦；大麦粒
beet|n. 甜菜；甜菜根
bland|adj. 温和的；和蔼的；淡味的；乏味的
broccoli|n. 花椰菜；西兰花
butter|n. 黄油；奶油；v. 涂黄油于...上
cabbage|n. 卷心菜
carrot|n. 胡萝卜
celery|n. 芹菜
cereal|n. 谷物；谷类食品；麦片
chop|v. 砍；劈；剁；n. 砍；剁；排骨
coarse cereal|phrase. 杂粮
corn|n. 玉米；谷物
crop|n. 农作物；收成；v. 修剪；种植；收割
cucumber|n. 黄瓜
cuisine|n. 烹饪；菜肴；烹调风格
dry farmland|phrase. 旱作农田
edible|adj. 可食用的；可以吃的
farm|n. 农场；农庄；v. 耕种；务农
foodstuff|n. 食品；粮食
grain|n. 谷物；颗粒
highland barley|phrase. 青稞
inedible|adj. 不能吃的；不宜食用的
irrigated land|phrase. 灌溉耕地
leek|n. 韭葱；扁葱
lettuce|n. 生菜；莴苣
millet|n. 小米；粟
mustard|n. 芥末；芥末酱
oat|n. 燕麦
onion|n. 洋葱
pea|n. 豌豆
peanut|n. 花生
pepper|n. 胡椒粉；辣椒；v. 使布满；向…不断射击
planting industry|phrase. 种植业
potato|n. 土豆；马铃薯
pumpkin|n. 南瓜
radish|n. 小萝卜
rice|n. 米饭
rotation|n. 旋转；循环
rye|n. 黑麦；裸麦；裸麦粒；裸麦威士忌酒；adj. 用黑麦制成的
sesame|n. 芝麻
soybean|n. 大豆
spinach|n. 菠菜
sugarcane|n. 甘蔗
tea|n. 茶；茶叶；茶水
tomato|n. 西红柿；番茄
wheat|n. 小麦；小麦色
disorient|v. 使迷失方向；使迷惘
entry|n. 进入；参与；参赛作品；条目；入口
entrance|n. 入口；进入；到场；v. 使出神；使入迷
access|n. 进入；通道；接触（的机会或权利）；v. 接近；使用；获取
exit|n. 出口；v. 退出；离去
forth|adv. 向前；向外；露出
frontal|adj. 前部的；正面的
horizon|n. 地平线；（思想等的）范围；眼界
lateral|adj. 侧面的；横向的
lateralize|v. （大脑）表现偏侧性
bilateral|adj. 两边的；双方的
oriental|adj. 东方的（尤指中国和日本）
orientation|n. 方向；定位；取向；岗前训练；入学介绍
outlet|n. 出口；发泄途径；经销店；折扣店
overhead|adv. 在头顶上；在空中；adj. 在头顶上的；在空中的
verge|n. 边缘；边界；v. 濒临；接近
zenith|n. 顶点；天顶；全盛
hollow|adj. 中空的；空洞的
container|n. 容器；集装箱
contain|v. 包含；容纳；克制；遏制
cover|v. 遮盖；包括；报道；n. 封面；遮盖物；庇护所
core|n. 核；核心；重点；v. 去（果）核
layer|n. 层；层次
molten|adj. 熔化的；熔解的
bubble|n. 气泡；沸腾；泡影；空想；v. （使）冒气泡；洋溢着
configuration|n. 结构；布局；配置；外形
detach|v. 脱离；拆卸；分离
ditch|n. 沟；渠；v. 开沟于；把…开入沟里；摆脱；抛弃；紧急降落
embed|v. （使）插入；（使）嵌入
emboss|v. 加浮雕花纹于；饰以浮饰；使凸出
gel|n. 凝胶体；定型发胶；v. 形成胶体；联手共事
harden|v. 使坚强；使坚硬
lapping|n. 研磨；轻拍；v. 舔食
lubricant|n. 润滑剂
lubricate|v. 润滑；加润滑油于
meld|v. （使）合并；（使）融合；（使）混合；n. 合并；混合
mosaic|n. 马赛克；镶嵌图案；v. 镶嵌；用马赛克装饰
mould|n. 霉；模具；v. 发霉；铸造
nugget|n. 天然贵重金属块；小圆块食物；（鸡）块；有用信息
perforate|v. 穿孔；打孔
refine|v. 精炼；改进
seam|n. 接缝；缝合处；矿层；煤层；v. 缝合；有裂痕
smelt|v. 熔炼；冶炼；v. 嗅；闻；散发气味；察觉；“smell”的过去式和过去分词；n. 胡瓜鱼
spark|n. 火花；火星；v. 触发；冒火花；闪光；激发
tinker|n. 补锅匠；v. 小修；小补；摆弄
weld|v. 焊接；n. 焊接
assemble|v. 装配；集合
assembly|n. 装配；集会；会议
behave|v. 表现；举止
conserve|v. 保藏；保护；保存；节约；n. 蜜饯；果酱
conservative|adj. 保守的；守旧的；n. 守旧派；保守主义者
fabricate|v. 编造；捏造；制造
generative|adj. 能生产的；生殖的；（语言学中）生成的
manufactured|v. 制造；虚构；捏造；“manufacture”的过去式和过去分词
manufacturer|n. 制造商
mechanical|adj. 机械的；无思想的
preserve|v. 保存；保护；保持；n. （某群体）专有的活动；保护区
keep|v. 继续；保持；保留
store|n. 商店；店铺；仓库；储存；v. 贮藏；存储
productive|adj. 生产的；多产的；富有成效的
item|n. 项目；条款；一则； 一件物品或商品
board|n. 板；董事会；v. 上船（或火车、飞机等）
canvas|n. 帆布；帆布画布
craft|n. 工艺；手艺；诡计；行业；小船；艇；航空器；v. 精心制作
entity|n. 独立存在体；实体
girdle|n. 紧身褡；腰带；围绕物；v. 以腰带束缚；围绕
leash|n. 牵狗的链子或皮带；控制；约束
souvenir|n. 纪念品；纪念物
spur|n. 马刺；鞭策；v. 刺激；鞭策
stick|v. 粘附；刺；（随意）放置；卡住；忍受；n. 棍枝；球棍；条状物，（一）根
strip|v. 剥去；剥夺；脱衣；n. 长条；条状
tugboat|n. 拖船
varnish|n. 清漆；漆面；光泽面；v. 给…涂上清漆
vessel|n. 器皿；容器；船；血管
cavern|n. 大洞穴；大山洞
cavity|n. 腔；窝；洞；孔
empty|adj. 空的；v. 倒空；变空
evacuate|v. 撤离；疏散；撤出
evacuation|n. 撤离
vacant|adj. 空缺的；空虚的；茫然若失的
vacuous|adj. 空虚的；茫然的；空洞的
vacuum|n. 真空；空虚；v. 用真空吸尘器打扫
void|adj. 空的；缺乏的；无效的；n. 空白；空虚；v. 取消；使无效
theorist|n. 理论家
ideal|adj. 理想的；n. 理想；典范
idealistic|adj. 理想主义的；空想的；唯心论的
ideally|adv. 理想地；理论上
pride|n. 骄傲；自豪；自尊；v. 对…感到自豪
collective|adj. 集体的；共同的；n. 集体
accomplishment|n. 成就；完成
credit|n. 赞扬；荣誉；赊账；信用；贷款；学分；v. 相信；给银行账户上存钱
give ... credit for|phrase. 因…赞扬
discredit|n. 不信任；名誉丧失；信誉丧失；v. 不信；败坏名声；使丢脸
belief|n. 信仰；信念
credibility|n. 可信性；可靠性
credible|adj. 可信的；可靠的
incredible|adj. 难以置信的
faith|n. 信心；信仰；信任；真诚；忠实
persuade|v. 说服；劝说
aesthetician|n. 美学家
aesthetics|n. 美学；审美学
astrologist|n. 占星家
astrology|n. 占星术；占星学
botanist|n. 植物学家
demographer|n. 人口统计学家
demography|n. 人口统计学
ecologist|n. 生态学家；生态学者
entomologist|n. 昆虫学家
entomology|n. 昆虫学
ethnologist|n. 民族学家
ethnology|n. 人种学
geographer|n. 地理学者
geologist|n. 地质学家
geology|n. 地质学
linguistician|n. 语言学家
linguistics|n. 语言学
mathematician|n. 数学家
meteorologist|n. 气象学家
meteorology|n. 气象学
neurologist|n. 神经病学家；神经科专门医师
neurology|n. 神经病学；神经学
oceanographer|n. 海洋学家；海洋学者
oceanography|n. 海洋学
ornithologist|n. 鸟类学家
ornithology|n. 鸟类学
paleontologist|n. 古生物学者
paleontology|n. 古生物学
pathologist|n. 病理学家；病理学者
philosopher|n. 哲学家
philosophy|n. 哲学
physiologist|n. 生理学家；生理学研究者
physiology|n. 生理学；生理机能
seismologist|n. 地震学家
seismology|n. 地震学
conceal|v. 隐藏；隐瞒
cryptic|adj. 隐秘的；秘密的；隐晦的
dissemble|v. 掩饰；假装；隐藏
feign|v. 假装；装作
hide|v. 隐藏；躲藏；隐瞒；n. 兽皮；人皮
lurk|v. 潜伏；隐藏；n. 潜伏；埋伏
pretend|v. 假装；佯装；自称
seclusion|n. 隐居；隔绝
sneak|v. 溜；偷偷地做；adj. 突然的；出其不意的；n. 鬼鬼祟祟的人；偷偷摸摸
think of sb. as sth.|phrase. 把某人当作某物
think of sth. as sth.|phrase. 把某物当作某物
essentially|adv. 本质上；基本上；根本上
essential|adj. 必需的；基本的；本质的；n. 必需品
visual|adj. 视力的；视觉的
experience|v. 经历；体验；n. 经验；阅历
afford|v. 买得起；担负得起；有时间做；给予
affordable|adj. 支付得起的
underestimate|v. 低估；对…估计不足；n. 低估；轻视
importance|n. 重要性；重要
action|n. 行动；行为
adaptation|n. 适应；改编的作品
adaptable|adj. 能适应的；可适用的
adapter|n. 改编者；适配器；多头电源插座
board of censors|phrase. 审查委员会；审查署
cast|v. 投射；投掷；扔；n. 全体演员
casting|v. 投掷；抛；“cast”的现在分词；n. 铸件
censor|n. 审查员；检查员；v. 检查；审查
censorship|n. 审查；审查制度
cinematographer|n. 电影摄影师
cinematography|n. 电影术；电影摄影学
close-up|n. 特写照片；特写镜头
costume|n. 服装；衣服；戏服；v. 给…穿上服装
crew|n. 全体船员；全体人员
cutting|n. 切割；剪报，剪辑；v. 切；割；削减；“cut”的现在分词；adj. 锐利的；像£割似的
director|n. 指导者；主任；导演；董事
dissolve|v. 溶解；解散；散去；失控
dub|v. 起绰号；把…称作；配音；译制
edit|v. 编辑；剪辑
exterior|n. 外观；外表；adj. 外面的；外部的
film industry|phrase. 电影工业；电影产业；电影业
filmmaking|n. 电影制作
full shot|phrase. 全景
in the spotlight|phrase. 在聚光灯下；成为焦点
leading actor and actress|phrase. 男女主角；主演
lighting|n. 照明；灯光；v. 点燃；照亮；“light”的现在分词
long shot|n. 成功希望很小的冒险
play a role|phrase. 起作用；扮演角色
plot|n. 小块用地；图表；情节；阴谋；秘密计划；v. 划分；设计情节；绘图；密谋
poster|n. 海报；招贴画；宣传画
scenario|n. 设想；可能发生的情况；情节梗概
scenarist|n. 编剧
screen|n. 屏幕；屏风；掩蔽物；v. 筛查；掩蔽；放映
screening|n. 筛查；放映；播放；v. 掩蔽；包庇；放映；拍摄；筛；“screen”的现在分词
screenplay|n. 电影剧本
screenwriter|n. 电影剧本作家；编剧家
scriptwriter|n. （电影、电视剧、广播剧的）剧作家
setting|n. 环境；背景；（日月的）沉落；v. 设置；放；“set”的现在分词
shooting|n. 射击；发射；v. 射击；射门；疾驰；“shoot”的现在分词
slow motion|phrase. 慢动作
sound effect|phrase. 音效
sound recording|phrase. 录音；录音资料
soundtrack|n. 声道；音带；声迹；电影的配乐
special effect|phrase. 特技效果
stand-in|n. 临时替代者；替身演员
storyline|n. 故事情节
supporting actor and actress|n. 男女配角
video camera|phrase. 摄像机
visual effect|phrase. 视觉效果
walk-on|n. 小角色，龙套角色；adj. （角色）跑龙套的
3D glasses|phrase. 3D眼镜
animation|n. 活跃；生气；兴奋；动画
anime|n. 日本动漫
banned film|phrase. 禁映影片；禁片
box office|n. 售票处；票房收入
catch a flick|phrase. 看电影
clip|n. 小夹子；回形针；（电影）片段；剪报；v. 修剪；夹住
drive-in theater|phrase. 汽车电影院
film festival|phrase. 电影节
IMAX|abbr. 宽银幕投影系统；“Image Maximum”的缩写
late movie|phrase. 晚场电影
movie star|phrase. 电影明星
must-see movie|phrase. 必看的电影 ；不容错过的电影
popcorn|n. 爆米花
preview|n. 预审；预看；试映；预习；v. 预映；预看；预习；写预评
release time|phrase. 释放时间
stereo glasses|phrase. 立体眼镜
tearjerker|n. 催人泪下的作品
ticket|n. 票；车票
touching|adj. 感人的；动人的；prep. 关于；涉及；v. 触摸；接触；触动；“touch”的现在分词
moving|adj. 感人的；动人的；可移动的；运动的；v. 移动；搬家；“move”的现在分词
zombie|n. 僵尸
action film|phrase. 动作片
affectional film|phrase. 爱情电影；爱情片
comedy|n. 喜剧
detective film|phrase. 侦探片
documentary|adj. 记录的；文书的；纪实的；n. 纪录片
martial arts movie|phrase. 武侠片；武打电影
newsreel|n. 新闻短片
romantic comedy|phrase. 浪漫喜剧；爱情喜剧
thriller|n. 惊险小说（或戏剧、电影）
transport|n. 运输；v. 运输
transportation|n. 运输；交通工具；运输系统
concern|v. 涉及；担忧；n. 担忧；挂念；关注；关心
due|adj. 预期的；应给的；到期的
extent|n. 长度；广度；程度
a set of|phrase. 一组；一副；一套
circa|adv. 大约
cubic|adj. 立方的
dozen|n. 很多； 一打；十二个
gallon|n. 加仑
gram|n. 克
gross|adj. 总的；严重的；过分的
in length|phrase. 长度上
liter|n. 公升
metric|adj. 米制的；公制的
net weight|phrase. 净重
ounce|n. 少量；盎司
pound|n. 镑；英镑；v. 连续重击；捣碎
specification|n. 规格；规范
tare|n. 皮重；杂草 ；vt. 称皮重
the number of|phrase. …的数目
tolerance|n. 宽容；忍耐力
ton|n. 吨
absolute|adj. 完全的；绝对的
barely|adv. 仅仅；几乎不
merely|adv. 仅仅；只不过
categorical|adj. 绝对的；确定无疑的；分类的
definite|adj. 肯定的；确定的
positive|adj. 积极的；正面的
unconditional|adj. 无条件的；无限制的；绝对的
clean|v. 打扫；使干净；adj. 洁净的；干净的
totally|adv. 完全地
completely|adv. 非常；完全地
complete|adj. 完整的；完成的；v. 完成；使完整
dead|adj. 死的；n. 死；死人；adv. 完全地；绝对地
drastic|adj. 激烈的；急剧的；猛烈的
violent|adj. 暴力的；猛烈的
entirely|adv. 完全地；全部地；彻底地
solely|adv. 只；仅；唯；单独地
exorbitant|adj. 过度的；过高的；过分的
excessive|adj. 过度的；过分的
unreasonable|adj. 不理智的；不合理的；过度的
fairly|adv. 公正地；相当地
relatively|adv. 相对地；比较地
grossly|adv. 非常；极度地；极其
greatly|adv. 非常；大大地；很
hardly|adv. 几乎没有；简直不
scarcely|adv. 几乎不；刚刚；决不
imperative|adj. 紧急的；极重要的；祈使的；n. 紧急的事；祈使语气
necessary|adj. 必需的；必要的；必然的
urgent|adj. 紧急的；紧迫的
impetuous|adj. 鲁莽的；冲动的
inordinate|adj. 过度的；无节制的
immoderate|adj. 无节制的；不适中的；过度的
intense|adj. 强烈的；剧烈的；紧张的
severe|adj. 严重的；非常困难的；严厉的
intensive|adj. 密集的；增强的
concentrated|adj. 浓缩的；密集的；全神贯注的；v. 集中；浓缩；“concentrate”的过去式和过去分词
nearly|adv. 几乎；将近；差不多
almost|adv. 几乎；差不多
profoundly|adv. 深深地；深刻地
deeply|adv. 深深地；深刻地；非常
rough|adj. 粗糙的；粗暴的；粗略的；艰苦的；adv. 粗野地；艰苦地
approximate|adj. 近似的；大约的；v. 接近；粗略估计
roughly|adv. 粗略地；大约；粗暴地
approximately|adv. 大约；大概
sharp|adj. 锋利的；灵敏的；尖刻的；骤变的
sudden|adj. 突然的；忽然的；n. 突然发生
somewhat|adv. 有点；稍微
to some degree|phrase. 从某种程度上来说
utterly|adv. 全然地；绝对地
absolutely|adv. 绝对地；完全地
vehemence|n. 热烈；强烈；猛烈；愤怒
vehement|adj. （感情）强烈的；激烈的
deform|v. （使）变形；使畸形
deformation|n. 变形；畸形；变态
deformed|adj. 畸形的；变形的；v. （使）变形；使畸形；“deform”的过去式和过去分词
fickle|adj. 易变的；无常的；感情不专的
track|n. 轨道；踪迹；小路；跑道；v. 追踪；跟踪
temporal|adj. 时间的；世俗的；暂存的
inventor|n. 发明家；发明者；创造者
sundial|n. 日晷；日规
length|n. 长度
direction|n. 方向；指导；指示；命令
decimalism|n. 十进制
decimal|adj. 小数的；十进位的；n. 小数
gunpowder|n. 火药；有烟火药
hieroglyphic|adj. 象形文字的
paper-making|n. 造纸；造纸术
printing|n. 印刷；印刷术；v. 打印；印刷；“print”的现在分词
seismograph|n. 地动仪；测震仪
waterwheel|n. 水车；吊水机
antiquarian|n. 古文物研究者（或收藏家、经营者）；adj. 古物的；文物的
Bronze Age|n. 青铜器时代
Iron Age|n. 铁器时代
material culture|phrase. 物质文化；物质文明
abiding|adj. 持久不变的
abrupt|adj. 突然的；唐突的；粗鲁无礼的；不连贯的；陡峭的
chronic|adj. 长期的；慢性的
concur|v. 意见一致；同意
concurrent|adj. 同时发生的
contemporary|adj. 现代的；当代的；同时代的；n. 同代人；同辈人；同龄人
cursory|adj. 匆匆的；粗略的；仓促的
dated|adj. 过时的；陈旧的；v. 标日期；约会；追溯到；“date”的过去式和过去分词
duration|n. 持续时间；期间
elapse|v. 逝去；过去；n. （光阴）逝去
eternal|adj. 不朽的；永久的
everlasting|adj. 永久的；永恒的；经久不变的
extant|adj. 尚存的；现存的
extemporaneous|adj. 即席的；临时的；无准备的；不用讲稿的
former|adj. 以前的；前者的；n. 模子
formerly|adv. 以前；从前；原来
hasty|adj. 匆忙的；草率的；急躁的
immediate|adj. 立即的；即刻的；¸近的；紧接的
immediately|adv. 立即；马上；conj. 即刻
impromptu|adj. 无准备的；即兴的；即席的；adv. 无准备地；即兴地；即席地
improvise|v. 即兴创作；即兴表演；临时准备
instantaneous|adj. 瞬间的；即刻的
interlude|n. 间歇；插曲；幕间节目
juncture|n. 时刻；关头；接合
lasting|adj. 持久的；恒久的；v. 持续；“last”的现在分词
lately|adv. ¸近；近来
nocturnal|adj. 夜间活动的；夜间发生的
obsolete|adj. 过时的；废弃的；淘汰的
overdue|adj. 过期的；未还的；逾期的
perennial|adj. 永久的；反复出现的；多年生的；n. 多年生植物
permanent|adj. 永久的；持久的
pressing|adj. 紧迫的；紧急的；v. 按；压榨；“press”的现在分词
previous|adj. 先前的
previously|adv. 以前；先前
schedule|n. 日程表；时间表；v. 安排
session|n. 会议；会期；开庭；学期；一段时间
simultaneously|adv. 同时地
synchronise|v. （使）同步；（使）同速进行
temporary|adj. 短暂的；临时的
transient|adj. 短暂的
transitory|adj. 暂时的；片刻的；转瞬即逝的
analysis|n. 分析；剖析
analyst|n. 分析者；化验员
analyse|v. 分析
figure|n. 数字；身材；重要或有名的人物；v. 计算；认为；弄懂
proportion|n. 比例；份额
seed|n. 种子；籽；v. 播种；结籽
germinate|v. 使发芽或发育；使产生
detail|n. 细节；详情；详细；v. 详述；细说；派遣
impressive|adj. 令人印象深刻的；令人钦佩的
affecting|adj. 感人的；动人的；v. 影响；“affect”的现在分词
impressively|adv. 令人难忘地
blossom|v. 开花；兴旺；发展；n. （果树的）花朵；兴旺；发展
bud|n. 芽；蓓蕾；v. 发芽
cross-breed|v. 杂交
fructification|n. 果实；结果实
fruit|n. 水果；成果；v. 结果实
fruition|n. 取得成果；实现；完成
germ|n. 病菌；萌芽
immature|adj. 不成熟的
kernel|n. 核心；仁；谷粒；要点
life cycle|phrase. 生活周期；存在周期
luxuriant|adj. 茂密的；茂盛的；华丽的
photosynthesis|n. 光合作用
photosynthetic|adj. 光合的
pistil|n. 雌蕊
pollen|n. 花粉
pollinate|v. 授粉；传粉
respiration|n. 呼吸；呼吸作用
respiratory|adj. 呼吸的；与呼吸有关的
ripe|adj. 成熟的
shell|n. 壳体；贝壳；炮弹；v. 剥…的壳；去…的皮；炮轰；炮击
shoot|v. 射击；射门；疾驰；n. 发射
sow|v. 播种；散布
sprout|v. 发芽；长出；迅速成长；涌现；n. 苗芽；新芽
stamen|n. 雄蕊
starch|n. 淀粉；淀粉浆；v. 给（布）上浆
tassel|n. 流苏；缨；穗；v. 用流苏装饰；摘下…穗
transplantation|n. 移植；迁移
transplant|v. 移栽；移植；n. 移植
wither|v. （使）枯萎；（使）衰弱
arboreal|adj. 树木的；树栖的
deciduous|adj. 每年落叶的；定期脱落的；非永久性的
foliage|n. 叶子（总称）；簇叶
hawthorn|n. 山楂树
leaf|n. 叶；叶片
leaflet|n. 传单；单页宣传品；复叶的一叶；v. 散发传单
leafstalk|n. 叶柄
stalk|n. 茎；柄；梗；v. 跟踪；偷偷接近；昂首阔步地走
stem|n. 柄；茎；词干；v. 阻止；起源于(~ from)
timber|n. 木材
tissue|n. 组织；纸巾；薄纸
vein|n. 静脉；矿脉；叶脉
bunch|n. 束；串；捆；一群；一帮；一伙
daffodil|n. 黄水仙；水仙花
flora|n. 植物群落
floral|adj. 花的；饰以花的
horticulture|n. 园艺（学）
jasmine|n. 茉莉
orchid|n. 兰花；淡紫色
ovary|n. 卵巢；（植物的）子房
petal|n. 花瓣
sunflower|n. 向日葵
tulip|n. 郁金香
fern|n. 蕨类植物
mushroom|n. 蘑菇；v. 迅速增长
shrub|n. 灌木
bush|n. 灌木丛；矮树
scrub|n. 擦洗；刷洗；灌木丛；v. 擦洗；刷洗
botany|n. 植物学
botanical|adj. 植物的；植物学的；n. 植物性药材
vegetable|n. 蔬菜
vegetative|adj. 植物的；植物生长的；植物人状态的
vegetal|adj. 植物的；植物性的
vegetarian|n. 素食者；食草动物；adj. 素食者的；素菜的
vegetarianism|n. 素食主义
vegetation|n. 草木；（统称）植物
Inuit|adj. 因纽特人的；n. 因纽特人
actually|adv. 事实上；实际上；竟然
starve|v. 挨饿；饿死
curtail|v. 缩短；限制；缩减
climate|n. 气候；（社会）风气；一般（社会）趋势
certainly|adv. 毫无疑问地；确定地；当然
impact|n. 冲击（力）；影响力；v. 冲击；撞击；对…产生影响
anthropogenic|adj. 人为的；人类起源的
biomass energy|phrase. 生物质能
climate change|phrase. 气候变化
greenhouse|n. 温室；玻璃暖房
heat|n. 热度；热；v. 加热
off-gas|n. 煤气；废气
off-gas line|phrase. 排气管道
precipitation change|phrase. 降水变化
species extinction|phrase. 物种灭绝
littoral climate|phrase. 海滨气候
monsoon climate|phrase. 季风气候
plateau climate|phrase. 高原气候
polar climate|phrase. 极地气候
sub-tropical climate|phrase. 亚热带气候
temperate climate|phrase. 温和气候
tropical climate|phrase. 热带气候
tropical marine climate|phrase. 热带海洋气候
activity|n. 活动；活跃
austere|adj. 简朴的；严厉的；苦行的；紧缩的
biological clock|phrase. 生物钟
chaotic lifestyle|phrase. 混乱的生活方式
deep breath|phrase. 深呼吸
detoxify|v. 使解毒；使戒毒
diet|n. 日常饮食；v. 节制饮食
dietary|adj. 饮食的；膳食中的
digest|n. 摘要；文摘；v. 消化；领会
do exercise|phrase. 做运动；锻炼
exercise|n. 练习；锻炼；运动；行使；v. 运用；使用；锻炼；使担忧
fitness|n. 适宜；健康；健壮
health|n. 健康；健康状况
healthful|adj. 有益健康的
healthy lifestyle|phrase. 健康的生活方式
keep fit|phrase. 保持健康；健身
keep in good health|phrase. 保持身体健康
keep warm|phrase. 保暖
lifestyle|n. 生活方式
living habit|phrase. 生活习性
massage|v. 按摩；揉；n. 按摩；揉
meditation|n. 冥想；沉思
nourishing|adj. 有营养的；滋养多的；v. 滋养；培养；养育；“nourish”的现在分词
peace|n. 和平；平静
perspire|v. 出汗；流汗
reasonable rest|phrase. 合理休息
sit still|phrase. 静坐
sleep|n. 睡眠；v. 睡觉
tonic|n. 补药；滋补品；奎宁水
tranquil|adj. 安静的；平静的；宁静的
unhurried|adj. 从容不迫的；不慌不忙的；悠闲的
wellbeing|n. 幸福
barometer|n. 晴雨表；气压计
blizzard|n. 暴风雪；大量
convection zone|phrase. 对流层；对流区
droplet|n. 小滴
drought|n. 旱灾；干旱
funnel|n. 漏斗；烟筒；v. 通过狭窄空间；输送
gale|n. 大风；一阵（喧闹）
hurricane|n. 飓风
ozone layer|phrase. 臭氧层
tempest|n. 暴风雨；骚动
tornado|n. 龙卷风；旋风
troposphere|n. 对流层
typhoon|n. 台风
whirlwind|n. 旋风；一片忙乱；adj. 旋风似的；快速的；匆匆忙忙的
image|n. 图像；形象；画面；影像
puzzle|n. 谜；难题；拼图；v. （使）迷惑；（使）伤脑筋
decipher|v. 破译；解读；n. 密电译文
rewarding|adj. 有报酬的；有益的；值得的；v. 奖励；报酬；“reward”的现在分词
reward|n. 奖励；报酬；v. 奖励；回报
recognition|n. 认识；识别；承认；认可；褒奖；酬劳
complacent|adj. 自满的；自鸣得意的
content|n. 内容；含量；目录；adj. 满足的；v. 使满意
contented|adj. 满足的；v. 使满足；“content”的过去式和过去分词
fulfilled|adj. 满足的；v. 完成；满足；“fulfill”的过去式和过去分词
fulfil|v. 履行；实行；满足
fulfilment|n. 实现；履行；满足
gratify|v. 使满足；使高兴
gratification|n. 满足；满意
relieved|adj. 感到宽慰的；感到安心的；v. 减轻；缓解；“relieve”的过去式和过去分词
relieve|v. 减轻；缓解
relief|n. 减缓；解脱；宽慰；救济
satiate|v. 使饱足；使厌腻；充分满足
satisfaction|n. 满意；满足
satisfactory|adj. 令人满意的
unsatisfactory|adj. 不够好的；不能令人满意的
satisfy|v. 使满意；使满足
dissatisfied|adj. 不满意的；不高兴的；v. 使不满意；“dissatisfy”的过去式
suffice|v. 足够；足以；使满足
adversity|n. 逆境；不幸
adverse|adj. 不利的；有害的；相反的；敌对的
arduous|adj. 艰巨的；费力的
complicated|adj. 复杂的
confront|v. 面对；遭遇；对抗
deadlock|n. 僵局；僵持
despairing|adj. 绝望的；无望的；v. 绝望；失望；“despair”的现在分词
dilemma|n. （进退两难的）窘境
elusive|adj. 难以捉摸的；不易被抓获（觉察、理解或记忆）的
elude|v. 躲避；把（某人）难倒
embarrass|v. 使窘迫；使尴尬
embarrassed|adj. 尴尬的；窘迫的；v. 使窘迫；使尴尬；“embarrass”的过去式和过去分词
embarrassing|adj. 令人尴尬的；令人为难的；v. 使窘迫；使尴尬；“embarrass”的现在分词
embarrassingly|adv. 令人尴尬地
embarrassment|n. 窘迫；难堪；困境
flounder|v. 挣扎；深陷困境；n. 比目鱼
handicap|n. 障碍；阻碍；不利；v. 妨碍；使不利
handicapped|adj. 有生理缺陷的；残疾的；弱智的；v. 妨碍；使不利；“handicap”的过去式和过去分词
harsh|adj. 严厉的；严酷的；刺耳的
hassle|n. 麻烦；困难；争吵；v. 烦扰；纠缠
hiccup|n. 打嗝声；v. 打嗝
intricate|adj. 错综复杂的
involved|adj. 有关的；有牵连的；繁杂的；v. 牵涉；包括；“involve”的过去式和过去分词
knotty|adj. 多结节的；难以解决的；棘手的
laborious|adj. 耗时费力的；辛苦的；艰难的；艰涩的
opaque|adj. 不透明的；难懂的；晦涩的
opaquely|adv. 难理解地
opaqueness|n. 不透明性；晦涩
painstaking|adj. 辛苦的；苦干的
plight|n. 境况；困境；v. 保证；发誓
precipitous|adj. 险峻的；急促的；急躁的
predicament|n. 困境；窘境；危境
quandary|n. 困境；窘境；困惑之境；进退两难
rigorous|adj. 严密的；缜密的；严格的
rigorously|adv. 严格地
stranded|adj. 搁浅的；处于困境的；束手无策的；v. 使滞留；使搁浅；“strand”的过去式和过去分词
strand|n. 一缕；一股；方面；海滨；河岸；v. 使滞留；使搁浅
strenuous|adj. 费力的；繁重的；艰苦的；发奋的
stringent|adj. 严苛的；短缺的；迫切的
troublesome|adj. 令人烦恼的；讨厌的；困难的
material|n. 材料；原料；adj. 物质的
appear|v. 出现；似乎；显得
comparatively|adv. 比较地；相对地
trivial|adj. 不重要的；琐碎的；微不足道的
trifling|adj. 微不足道的；无关紧要的；v. 闹着玩；玩弄；“trifle”的现在分词
petty|adj. 琐碎的；微不足道的；心胸狭窄的
important|adj. 重要的
main|adj. 主要的；¸重要的
supplier|n. 供应商
supply|n. 供应；供给；v. 供给
customer|n. 客户；顾客；主顾
bid|v. 出价；投标；吩咐；向某人道（午安等）；n. 出价；投标；努力争取
bidding|n. 命令；出价；投标；叫牌；v. 投标；出价；叫牌；恳求；命令；说（问候话）；“bid”的现在分词
commercial|adj. 贸易的；商业的；n. 广告
commerce|n. 商业；贸易
consolidate|v. 合并；统一；巩固
consolidation|n. 巩固；合并
contractor|n. 承包商；承包人；订约人
corporate|adj. 团体的；公司的
corporation|n. 公司；企业
earnings|n. 收入；利润
salary|n. 薪金
haggle|v. 争论；讲价；n. 讨价还价；争论
payment|n. 支付；报酬
adhesive|adj. 可黏着的；黏性的；n. 黏合剂；胶黏剂
attendance machine|phrase. 考勤机
blotter|n. 吸墨纸；记事簿
bookend|n. 书挡
book stand|phrase. 书立；书架；书摊
briefcase|n. 公文包；手提包
cabinet|n. 储藏柜；内阁
cellophane tape|phrase. 透明胶带
clasp envelope|phrase. 铁钩信封；带有扎扣的封套；搭扣信封
copier|n. 抄写员；复印机；抄袭者
correction fluid|phrase. 修正液
correction pen|n. 修正液
correction tape|n. 修正带
cutter|n. 切割者；切割机；裁切器；小汽艇
desk calendar|phrase. 台历
expanding file|phrase. 风琴包；文件袋；文件夹
fastener|n. 扣件；纽扣；拉链；使系牢之物
fax|n. 传真；v. 发传真
floppy disk|phrase. 软磁盘
holder|n. 持有者；拥有者；支架
inkpad|n. 印泥；打印台
intercom|n. 内部通话系统（或设备）； 对讲机
locker|n. （有锁的）寄物柜；锁柜；上锁的人
mouse pad|phrase. 鼠标垫
office equipment|phrase. 办公设备
office supply|phrase. 办公用品；办公文具；办公用品专业店
office table|phrase. 办公桌
pad|n. 垫；爪垫；便笺簿；v. 放轻脚步走
pin|n. 大头针；别针；v. （用大头钉等）固定
printer|n. 印刷工人；印刷厂；打印机
printing ink|phrase. 印刷油墨
projector|n. 投影仪；放映机
scanner|n. 扫描仪；扫描器
stapler|n. 订书机
stationery|n. 文具
voice recorder|phrase. 录音机；录音功能
access to|phrase. 有权使用；有机会接近
adequate preparation|phrase. 充分的准备
be acquainted with|phrase. 与…相识；对…熟悉
business cycle|phrase. 商业周期
business letter|n. 商业书信
enclose|v. 围起；附上；封入
essential factor|phrase. 要素
financial gain|phrase. 经济收益
win-win situation|phrase. 双赢的局面；共赢
tin|n. 锡；罐头
surface|n. 表面；v. 显露；给…铺路面
flat|adj. 平坦的；扁平的；平淡无味的；（说话）断然的；（轮胎）瘪了的；n. 公寓；平坦部分；adv. 直接地
horizontal|adj. 水平的
horizontally|adv. 水平地；横向地
parallel|adj. 平行的；相似的；相同的；v. 平行；类似；n. 类似的事物；相似之处
blowdown|n. 排污
brim|n. 边；边缘；帽边；v. （装）满；（使）溢出
composite|adj. 合成的；复合的；n. 合成物；复合材料
convolute|v. 回旋；卷绕；盘旋；adj. 旋绕的；盘旋的
demanding|adj. 要求高的；苛求的；费力的；v. 需要；“demand”的现在分词
distend|v. 膨胀；肿大；使扩张；使膨胀
flow model|phrase. 流动模型
flow sheet|phrase. 流程图；作业图
foam|n. 泡沫；泡沫塑料；泡沫状物；v. 起泡沫
intertwine|v. （使）缠结；纠缠；交织
invert|v. 使倒置；使颠倒
malleable|adj. 可塑的；有延展性的；易改变的
meshed|adj. 网状的；n. 网孔；“mesh”的过去式
mold|n. 模具；霉菌；v. 制模；塑造；发霉
on stream|phrase. （投入）生产；（投入）使用
on-stream inspection|phrase. 运转中检查；不停车检查；在线检查
procedural model|phrase. 程序模型；过程模型
rotate|v. 转动；轮作；轮流
rust|n. 铁锈；v. 生锈
scrap|n. 小块；碎片；废金属；吵架；v. 废弃；取消；adj. 废弃的
sectional|adj. 某群体的；截面的；可组合的；区域的
trek|v. 长途跋涉；n. 艰苦跋涉
wastage|n. 损耗；损耗量
wrought|adj. 制造的；精制的；锻造的
maintain|v. 保持；坚持认为；维护；供养
reserve|v. 保留；储备；预订；n. 储备；保留；保护区；候补
reservation|n. 预定；保留
retain|v. 保留；保持
radiate|v. 散发；发射（光或热）；辐射
radiation|n. 辐射；放射线
scorching|adj. 酷热的；烧焦似的；adv. 灼热地；v. 烧煳；烤焦；使枯萎；“scorch”的现在分词
sticky|adj. 黏的；棘手的
thermal|adj. 热的；保热的；温热的
warm|adj. 温暖的；v. （使）变暖
hot|adj. 热的
tropical|adj. 热带的
assume|v. 假定；设想；呈现；承担
improvement|n. 改进；改善
telecommunication|n. 电信；远距离通讯
lead to|phrase. 把…带到；导致；通向
dispersal|n. 分散；散布；疏散
no longer|phrase. 不再
force|n. 力；力量；武力；兵力；v. 强迫；促使；推动
addressee|n. 收信人；收件人
click rate|phrase. 点击率
cursor|n. 光标；游标
cyberspace|n. 网络空间
email|n. 电子邮件
Facebook|n. 脸谱网，脸书（社交网站）
friend circle|phrase. 朋友圈
internet media|phrase. 网络媒体
live broadcast|phrase. 现场直播
mass communication|phrase. 大众传播
mass media|phrase. 大众传播媒介
net friend|phrase. 网友
network communication|phrase. 网络通信；网络通讯
network|n. 网络；网路；网状物
one-to-many model|n. 一对多模型
social media site|phrase. 社交媒体网站
twitter|v. 吱吱喳喳；嘁嘁喳喳地讲；n. 叽叽喳喳的叫声
visit|v. 访问；参观；n. 访问；参观
website|n. 网站
WeChat|n. 微信
wide|adj. 宽的；宽阔的；广泛的；adv. 广阔地；广大地；张大地
aerial|adj. 空气的；空中的；n. 天线
answering|n. 回答；adj. 回答的；适当的；符合…的；v. 回答；回应；符合；“answer”的现在分词
area code|phrase. 电话区号
broadcast media|phrase. 广播媒体
broadcast|v. 广播；播送；n. 广播节目；电视节目
broadcasting|n. 广播；（无线电和电视的）节目制作和播放；v. 广播；播送；“broadcast”的现在分词
burgeoning|adj. 迅速发展的；迅速生长的；迅速成长的；v. 发芽；抽枝；迅速发展；“burgeon”的现在分词
cellphone|n. 手机
deliver information|phrase. 传递信息；送货信息
dial|n. 拨号；刻度盘；v. 拨
digital media|phrase. 数字媒体
direct dialing|n. 直接拨号
earphone|n. 耳机
extension|n. 延伸；扩展；延长期；电话分机
fixed-line|phrase. 固定线路；固线；固网
frequency adjustment|phrase. 调频；频率调整
function|n. 功能；职责；函数；v. 起作用； 运行；行使职责
handset|n. 电话听筒；手机
icon|n. 图标；画像；雕像；圣像；偶像
inbox|n. 收件箱
indoor aerial|phrase. 室内天线
infectivity|n. 传染性；传染力
International Direct Dialing|n. 国际直接拨号；国际直拨
leave a message|phrase. 留个话；留个口信
long distance call|phrase. 长途电话
long wave|phrase. 长波
loudspeaker|n. 扬声器；喇叭
make a call|phrase. 拜访
medium wave|phrase. 中波
megahertz|n. 兆赫兹
microblog|n. 微博
mobile phone|phrase. 移动电话
operator|n. 操作员；接线员
passcode|phrase. 密码
phone book|phrase. 电话簿
public radio|phrase. 公共广播电台；公共电台
put through|phrase. 使经受；接通（电话）
radio wave|phrase. 无线电波
radio|n. 收音机；无线电；无线电广播
reach|v. 达到；抵达；n. 伸手可及的距离
rebroadcast|v. 转播；重播；n. 转播；重播
receiver|n. 听筒；接收者
refresh|v. 使恢复精力；使复原；使变新
short wave|phrase. 短波
supervision|n. 监督；管理
tape recorder|phrase. 磁带录音机
telecom|n. 电信；远距离通讯
telephone|n. 电话；电话机
transmitter|n. 传播者；发射机；送话机
unavailable|adj. 难以获得的；不能利用的；没空的
voicemail|n. 语音信箱
wave length|phrase. 波长
working mode|phrase. 工作模式
compare|v. 比较；对比；比喻
invention|n. 发明；创造
inventive|adj. 发明创造的；有发明力的；有创造力的
pale|adj. 苍白的；（颜色）淡的
significance|n. 意义；重要性
significant|adj. 重大的；重要的；影响明显的；意味深长的
significantly|adv. 意味深长地；值得注目地；极大地
since|conj. 因为；由于；既然；从…以后；adv. 此后；后来；prep. 自…以后；从…以来
achieve|v. 完成；实现；达到；获得
achievement|n. 成就；成绩；完成
depend on|phrase. 依靠；依赖
originate|v. 起源；发源；创始
origination|n. 起源
originator|n. 创作者；发起人；创始人
originative|adj. 有创作力的
cardinal|adj. 首要的；大红色的；n. 红衣主教；枢机主教；基数
chief|n. 领袖；首领；adj. 主要的；首要的
chiefly|adv. 主要地；首要地；adj. 领袖（般）的
crucial|adj. 至关重要的；决定性的
dominant|adj. 支配的；占优势的；显性的
elementary|adj. 基本的；初级的
elite|n. （社会）精英；上层人士；adj. 精英的；出类拔萃的
fateful|adj. 重大的；命中注定的；决定命运的；预言性的
foremost|adj. ¸重要的；¸好的；adv. 首要地
fundamental|adj. 基本的；基础的；根本的；n. 基本原则；基本原理
gist|n. 要点；大意；主旨
key|n. 钥匙；关键；adj. 关键的
largely|adv. 大部分地；主要地；大量地
leading|adj. ¸重要的；一流的；处于领导地位的；v. 带领；领导；“lead”的现在分词
momentous|adj. 重要的；重大的
optimum|adj. ¸适宜的；¸佳的
outweigh|v. 大于；重于；超过
paramount|adj. ¸高的；至上的；¸重要的
pivotal|adj. 枢轴的；重要的；关键的
predominantly|adv. 占主导地位地；主要地
predominate|v. 占主导地位；占支配地位
primary|adj. ¸初的；首要的；初等的；小学的；原来的
primarily|adv. 主要地
principal|adj. ¸重要的；主要的；本金的；n. 负责人；首长；校长；本金
vital|adj. 至关重要的；所必需的；生死攸关的；充满活力的
comparative|adj. 比较的；相当的
contrast|n. 对照；反差；对立；v. 对比；和...形成对照
counterpart|n. 职务相当的人；对应物；相当之物；副本
equal|adj. 相等的；同等的；v. 等于；比得上；n. 同等的人；相等物
equality|n. 同等；平等
equally|adv. 平等地；同样地；相等地
equate|v. 同等看待；使等同
equivalent|adj. 相等的；等价的；n. 等价物
inferior|adj. 较差的；次等的；下级的
inferiority|n. 劣势；低等；自卑
peerless|adj. 无可匹敌的；盖世无双的
preferable|adj. 较合意的；更可取的
relative|n. 亲戚；adj. 比较的；相对的；相关联的
resemble|v. 相似；类似
superior|adj. 更好的；有优越感的；上级的；n. 上级；上司
versus|prep. 对…；与…相对
regulation|n. 规则；条例；管理
mercury|n. 水银；汞
emission|n. 散发；排放；放射
implement|v. 实施；执行；n. 工具；器具
implementation|n. 履行；实施
perform|v. 表演；执行；履行；表现
execute|v. 执行；实施；处死
utensil|n. 用具；器具
instrument|n. 仪器；乐器；工具；手段；法律文件
given|v. 给予；“give”的过去分词；prep. 考虑到；adj. 规定的
stipulate|v. 规定；订明；讲定；明确要求
acetate|n. 醋酸盐；醋酸酯；乙酸盐；乙酸酯
aluminium|n. 铝
amalgam|n. 汞合金；混合物
carbon dioxide|phrase. 二氧化碳
carbonic oxide|phrase. 一氧化炭
chemical element|phrase. 化学元素
cohere|v. 黏合；连结；附着；连贯；形成整体
coherent|adj. 连贯的；一致的；条理分明的
coke|n. 焦炭；(Coke：可口可乐商标的缩写)
copper|n. 铜；铜币
corrosive|adj. 腐蚀性的；起破坏作用的；n. 腐蚀性物品
desalinise|v. 脱盐；淡化
factorable|adj. 可分解因子的
foul|adj. 肮脏恶臭的；很令人不快的；很坏的；v. 使污秽；对…犯规；缠结难解；n. 犯规
gold|n. 金；金币；金黄色；adj. 金色的
halogen|n. 卤素
inert gases|phrase. 惰性气体
inorganic chemistry|phrase. 无机化学
inorganic matter|phrase. 无机物
inorganic polymer|phrase. 无机聚合物；无机高分子
iron|n. 铁；铁器；熨斗；镣铐；adj. 铁制的；坚强的；顽强的；v. 熨烫；用铁装备
lead|v. 领导；带领；导致；n. 铅
lifeless|adj. 死的；无生命的；死气沉沉的
natural polymer|phrase. 天然高分子；天然聚合物
organic chemistry|phrase. 有机化学
organic polymer|phrase. 有机聚合物；有机高分子
organics|n. 有机物
oxidize|v. （使）氧化；（使）生锈
patina|n. 铜绿锈；（金属表面的）绿锈；（旧木器等表面）年久而产生的光泽；（有点儿…的）样子
periodic table of elements|phrase. 元素周期表
polymer|n. 聚合体；聚合物
rare metal|phrase. 稀有金属
scalding|adj. 滚烫的；灼热的；v. 烫伤；“scald”的现在分词
silver|n. 银；银色；银器；adj. 银的；银色的；v. 镀银于；使 ... 成银色
sodium|n. 钠
supra polymer|phrase. 超高分子
synthetic fibre|phrase. 合成纤维；人造纤维
synthetic plastics|phrase. 合成塑料
synthetic rubber|phrase. 合成橡胶
titanium|n. 钛（元素符号为Ti）
toxic chemical|phrase. 有毒化学品
zinc|n. 锌
advisor|n. 顾问；导师
consultant|n. 顾问
consult|v. 咨询；查询；请教
dividend|n. 被除数；股份红利；股息
expected return|phrase. 预期收益
financial plan|phrase. 财务计划
financing|n. 筹措资金；理财；筹集资金；v. 提供资金；“finance”的现在分词
fixed income|phrase. 固定收入
foreign exchange|phrase. 外汇
forward rate|phrase. 远期汇率
futures|n. 期货；n. 未来；将来；前途；“future”的复数
house property|phrase. 房产
increment|n. 增加；增量
investment diversification|phrase. 投资多元化；分散投资
money management|phrase. 金钱管理
ratio|n. 比率；比值
risk assessment|phrase. 风险评估
store of value|phrase. 贮藏手段；价值贮存
systematic risk|phrase. 系统性风险
trust product|phrase. 信托产品
task|n. 任务；工作；作业
apply|v. 申请；应用；涂，敷
paraconsciously|adv. 超意识地
accessible|adj. 易接近的；可进入的；可使用的
consciousness|n. 意识；知觉
self-consciousness|n. 自我意识；不自然
conscious|adj. 有意识的；有知觉的；刻意的
altruistic|adj. 利他的；无私的
altruism|n. 利他主义；利他
confusion|n. 困惑，混乱；混淆
confuse|v. 迷惑；混淆
differentiation|n. 区别；分化；变异
differentiate|v. 区分；区别；辨别
egoism|n. 自我主义；利己主义
emotional state|phrase. 情绪状态
empathy|n. 移情作用；同感；共鸣
identification|n. 识别；鉴定；身份证明
identify|v. 鉴定；识别；确认
interaction|n. 相互作用；相互影响；互动交流
interact|v. 互相作用；互相影响；交流；沟通
introspection|n. 反省；内省
introspective|adj. 内省的；好反省的
inward|adv. 向内地；adj. 在内的；内心的
outward|adj. 向外的；表面的
metacognition|n. 元认知
psychology|n. 心理学；心理
self|n. 自我；本人
self-aware|adj. 自知的
all-round|adj. 全能的；多方面的；多才多艺的
all-round talent|phrase. 全能人才
basic education|phrase. 基础教育
basic quality|phrase. 基本素养
compulsory education|phrase. 义务教育
enlightening|adj. 有启迪作用的；v. 启发；开导；“enlighten”的现在分词
exam-oriented education|phrase. 应试教育
higher education|phrase. 高等教育
labor skill|phrase. 劳动技能
lower secondary education|phrase. 初级教育
moral value|phrase. 道德价值
pedagogy|n. 教育学；教学法
pedagogic|adj. 教育学的；教学法的
pre-primary education|phrase. 学前教育
primary education|phrase. 初等教育
quality-oriented education|phrase. 素质教育
registered school|phrase. 注册学校
amenable|adj. 顺从的；服从的
appropriate|adj. 适当的；恰当的；v. 拨出（专款）；盗用；侵吞
inappropriate|adj. 不适当的；不合宜的
consequently|adv. 从而；结果；因此
consequent|adj. 随之发生的；作为结果的
earnest|adj. 认真的；有决心的；真诚的
even-tempered|adj. 性情平和的
temper|n. 暴躁脾气；情绪；心情；性情；v. 使…缓和；冲淡
inherited|adj. 继承的；遗传的；遗留的；v. 继承；遗传；“inherit”的过去式和过去分词
inherit|v. 继承；遗传
lead by example|phrase. 以身作则；作榜样
maturation|n. 成熟（过程）；化脓
mature|adj. 成熟的；到期的；充分考虑的；v. 成熟；到期
modest|adj. 谦虚的；不多的；适度的
modesty|n. 谦虚；谦逊
naughty|adj. 顽皮的；淘气的
naughtiness|n. 顽皮；淘气
obedient|adj. 服从的；顺从的
obedience|n. 服从；顺从
outcome|n. 结果；成果
participate|v. 参与；参加
participant|n. 参与者；参加者
praise|v. 赞美；赞扬；n. 赞美；赞扬
promise|v. 承诺；答应；有希望；n. 许诺；希望；成功的征兆（或理由）
promising|adj. 有希望的；有前途的；v. 承诺；答应； “promise”的现在分词
puberty|n. 青春期；发育期
rebellion period|phrase. 叛逆期；反抗期
self-esteem|n. 自尊心
self-sufficiency|n. 自足；自给自足
conflict|n. 冲突；矛盾；v. 抵触；冲突
mouthpiece|n. 喉舌；送话口；乐器的吹口；代言人
executive|n. 决策人；行政官；管理人员；adj. 行政的；决策的
external|adj. 外部的；外界的
internal|adj. 内部的；国内的；n. 内脏；本质
mediator|n. 调解人；中间人；介质
Advertising Department|n. 广告部
Business Office|n. 营业部；办事处
department|n. 部门；系；部
division|n. 划分；分歧；除法；部门
Export Department|n. 出口部；外贸部
General Accounting Department|n. 财务部；财会部
General Affairs Department|n. 总务处；总务部
Human Resources Department|n. 人力资源部
Import Department|n. 进口部
International Department|n. 国际部；国际业务部
Personnel Department|n. 人事部；人事科
Planning Department|n. 企划部；策划部
Product Development Department|n. 产品开发部
Public Relations Department|n. 公关部；公共关系部门
Research and Development|n. （产品等的）研究与开发
Sales Department|n. 销售部；营业部
Technology Department|n. 技术部；技术部门
assist|v. 帮助；援助；协助
assistant|n. 助理；助手；adj. 助理的；辅助的
assistance|n. 帮助；援助；协助
service|n. 服务；v. 保养；维修
door-to-door service|phrase. 送货上门服务
admonish|v. 劝告；警告；训诫
unfavorable|adj. 不顺利的；相反的；令人不快的
harmful|adj. 有害的
assail|v. 攻击；困扰；抨击；袭击
baste|v. （烤肉时）润以脂油；狠揍；殴打；大骂；公开责骂
belligerent|adj. 交战的；寻衅的；好战的；n. 交战国；交战团体
compete|v. 竞争；比赛
contend|v. 声称；主张；竞争；争辩
emulate|v. 竞争；努力赶上；仿真；模仿
feud|n. 世仇；长期不和；夙怨；v. 长期斗争；结世仇
fulminate|v. 大声呵斥；强烈谴责
hostile|adj. 敌意的；敌对的
offensive|adj. 冒犯的；令人不快的；进攻性的
inoffensive|adj. 无害的；不触犯人的；不讨厌的
punch|n. 重拳击打；v. 拳打；打孔
repulsive|adj. 排斥的；令人厌恶的；使人反感的
rival|n. 竞争者；敌手；v. 竞争；相匹敌
strife|n. 争吵；争斗；冲突
struggle|v. 斗争；挣扎；抗争；n. 斗争；奋斗；抗争
tantalize|v. （以可望而不可即之物）逗引；使干着急
thump|v. 重击；捶击；发撞击声；n. 重击声；重打
chlorophyll|n. 叶绿素
molecule|n. 分子
capture|v. 逮捕；夺取；吸引；记录；准确地描述；n. 抓捕；攻占
convert|v. 转换；转变；变换；使...改变信仰；n. 皈依者
acorn|n. 橡子；橡实
bamboo|n. 竹子
birch|n. 桦树；赤杨；（体罚用的）桦树条
bough|n. 大树枝；粗树枝
box|n. 箱子；盒子；一拳；v. 拳击；装箱
branch|n. 分支；树枝；分公司
camphor tree|phrase. 香樟树
coconut palm|phrase. 椰子树
cypress|n. 柏树；柏树木
deciduous tree|phrase. 落叶乔木
elm|n. 榆树；榆木
evergreen broad-leaf forest|phrase. 常绿阔叶林
evergreen tree|phrase. 常青树
fir|n. 冷杉；枞树
ginkgo|n. 银杏
hardy|adj. 强壮的；能吃苦耐劳的；耐寒的
hardiness|n. 耐久力；顽强；耐劳
hickory|n. 山核桃树；山核桃
ivy|n. 常春藤
laurel|n. 月桂（树）
maple tree|phrase. 枫树
oak|n. 栎树；橡树；橡木
palm|n. 手掌；手心；棕榈
phoenix tree|phrase. 梧桐树
pine|n. 松树；松木；v. 渴望；苦思
poplar|n. 白杨；杨树
sandalwood|n. 檀香
satinwood|n. 椴木
sequoia|n. 红杉；巨杉
sycamore|n. 悬铃木
trunk|n. 树干；躯干；大衣箱；象鼻子
twig|n. 嫩枝；细枝；v. 察觉；明白
verdant|adj. 翠绿的；青翠的；长满绿色植物的
verdure|n. 青翠的草木
vine|n. 藤；藤蔓；藤本植物；葡萄藤
virgin|n. 处女；处男；adj. 未开发的；纯洁的
willow|n. 柳树；柳木
windbreak|n. 防风林
abound|v. 大量存在；有许多
overfill|v. 把...装得溢出
permeate|v. 渗透；弥漫；贯穿
permeation|n. 渗透
permeant|adj. 浸透的
penetrate|v. 渗透；看穿；洞察
teem|v. 充满；充斥
absorb|v. 吸收；理解；吸引；使全神贯注；缓冲
absorption|n. 吸收；专注；合并
assimilate|v. 吸收；消化；使同化
inhale|v. 吸入；吸气
inhalation|n. 吸入；吸入物；吸入剂
intake|n. 吸收之量；吸入；摄入
clothing|n. 衣服；服装
standard|n. 标准；adj. 标准的；规范的；权威的
determine|v. 决心；决定；测定；确定
determined|adj.  坚决的；坚定的；有决心的；v. 决心；决定；“determine”的过去式和过去分词
employee|n. 雇员；受雇者
employer|n. 雇主
employment|n. 就业；雇佣；职业
supervisor|n. 监督人；管理人；主管人
administrator|n. 管理人员；行政官员
apron|n. 围裙；停机坪
attire|n. 服装；衣服
beret|n. 贝雷帽（扁圆无檐）
cashmere|n. 开司米；山羊绒
cotton|n. 棉；棉花；棉布
fabric|n. 织物；布料；构造；（建筑物的）结构
garb|n. 服装；制服；装束；v. 穿衣
linen|n. 亚麻布；亚麻织品；adj. 亚麻布制的；亚麻色的
overall|adv. 全部；总计；大致上；n. （工作时穿的）罩衣；adj. 总的；全面的；总体的
overcoat|n. 大衣；外套
pajamas|n. 宽大的睡衣裤
scarf|n. 围巾；头巾；v. 围（围巾）；披（披巾）
shawl|n. 披肩；围巾
suit|n. 套装；西装；诉讼；v. 适合；相配
waistcoat|n. 背心；马甲
wool|n. 羊毛；毛线
abortive|adj. 失败的；夭折的；发育不完全的
blunder|n. 愚蠢的错误；失误；v. 犯愚蠢的错误；失误；跌跌撞撞地走
defective|adj. 有缺点的；有缺陷的；有毛病的
demerit|n. 过失；缺点
drawback|n. 缺点；不利条件
disadvantage|n. 不利；劣势；短处；v. 使处于不利地位
err|v. 犯错；出差错
erroneous|adj. 错误的；不正确的
erroneously|adv. 错误地
failure|n. 失败
fallible|adj. 易犯错误的；可能犯错的
flaw|n. 瑕疵；缺陷；裂痕；v. 使有裂纹；使有缺陷
flop|v. 猛落；沉重地落下；失败；n. 不成功
heedless|adj. 不留心的；不注意的
ignore|v. 忽视；忽略；置之不理
inaccurate|adj. 不精确的；不准确的；有错误的
incorrectly|adv. 不正确地；错误地
misjudge|v. 判断错误
neglect|v. 疏忽；忽视；不予重视；n. 疏忽；大意
negligence|n. 疏忽；过失；失职
negligent|adj. 疏忽的；粗心的；不在意的
offhand|adj. 即时的；未经准备的；唐突无礼的；adv. 即时地；未经思索地；随便地
omission|n. 遗漏；疏忽
omit|v. 省略；遗漏
regardless|adj. 不顾的；不注意的；adv. 不顾；不加理会
slovenly|adj. 不修边幅的；邋遢的
typo|n. 打字（或排印）文稿的小错误
impropriety|n. 不适当；不正确；不得体
incompetent|adj. 无能力的；不称职的；不能胜任的；n. 没有能力的人
ineligible|adj. 不合格的；不符合资格的
inept|adj. 不适当的；无能的；笨拙的
unbecoming|adj. 不恰当的；不得体的；无吸引力的
unseemly|adj. 不体面的；不相配的；不适宜的
nominate|v. 提名；推荐；指派
command|n. 命令；指挥；掌握；v. 命令；指挥；掌握
instruction|n. 指示；教授；指令；说明
mandatory|adj. 强制的；法定的；义务的
request|n. 请求；要求的事；v. 要求；请求
requisition|n. 正式要求；征用；v. 正式要求；征用
beforehand|adv. 预先；提前
before|prep. 在…之前；先于；adv. 以前；之前；conj. 在…以前
tune|v. 调整；调音；n. 曲调；调子
compose|v. 创作；组成；使镇定
composer|n. 作曲家
computer|n. 计算机；电脑
guess|v. 猜测；猜想；n. 猜测；猜想
speculate|v. 推测；思索；投机
rate|n. 比率； 率；速度；进度；价格；费用；地方税；等级；v. 估价；值得；定级；（被）认为；被评价
alto|n. 男声¸高音；女低音；adj. 中音部的
baritone|n. 男中音；男中音歌手
cantata|n. 康塔塔；清唱剧；大合唱
choir|n. 唱诗班；合唱
chorus|v. 合唱；异口同声地说；n. 合唱团；合唱
conservatory|n. 温室；音乐学校；艺术学校
soprano|n. 女高音；¸高音
tenor|n. 男高音；次中音乐器；大意
accordion|n. 手风琴
bagpipe|n. 风笛
band|n. 乐队；带子；一伙
banjo|n. 班卓琴
bass|n. 男低音；鲈鱼
bassoon|n. 低音管；巴松管
cello|n. 大提琴
clarinet|n. 单簧管；黑管
flute|n. 长笛
guitar|n. 吉他
harmonica|n. 口琴
harp|n. 竖琴；v. 反复诉说；唠叨
oboe|n. 双簧管
orchestra|n. 管弦乐队
organ|n. 器官；机构 ；风琴
pan pipes|n. 排箫；牧神萧
percussion|n. 碰撞；打击乐器
piano|n. 钢琴
saxophone|n. 萨克斯管
string|n. 弦；线；一连串
trombone|n. 长号；伸缩长号
trumpet|n. 喇叭；小号；v. 宣扬；吹嘘
viola|n. 中提琴
violin|n. 小提琴
wind|n. 风；v. 蜿蜒；缠绕
concerto|n. 协奏曲
duet|n. 二重唱；二重奏
episode|n. 一集；事件；一段经历；一段时期
lullaby|n. 摇篮曲；催眠曲
plainsong|n. 素歌；单旋律圣歌
sonata|n. 奏鸣曲
symphony|n. 交响乐；交响曲
chord|n. 弦；和弦；心弦
euphonious|adj. 悦耳的；动听的；和谐的
movement|n. 活动；运动；动作；乐章
pitch|v. 投掷；扎营；（猛地）向前倾跌；力荐（某主张）；n. 球场；程度（¸高点）；音高；沥青；宣传论点
prelude|n. 前奏；序曲；序幕
rest|v. （使）休息；（使）倚靠；停留在；中止；n. 休息；其他；剩余部分；宁静
rhythm|n. 节奏；韵律
scale|n. 规模；等级；秤；刻度；比例（尺）；v. 改变…大小；攀登
tone|n. 音调；色调；语气；氛围；强健状况；v. 使协调；使健壮
accelerate|v. 加速；加快
advanced science|phrase. 先进科学；高级科学
advanced|adj. 先进的；高级的；v. 前进；提前；“advance”的过去式和过去分词
advance|n. 发展；进步；提前；v. 前进；发展；提前；adj. 预先的；在前的
advent|n. 到来；出现
artificial reality|phrase. 人工现实；人造现实
artificial|adj. 人造的；人工的；假的
authentic|adj. 真正的；真实的；真迹的；可靠的
break boundaries|phrase. 打破界限
computer science|phrase. 计算机科学
cutting edge|phrase. £刃；尖端；¸前沿；优势
enhance efficiency|phrase. 提高效率；提高效益
boost efficiency|phrase. 提高效率
high-end|adj. 高端的；深受老练的、识货的顾客喜爱的
highly productive|phrase. 十分高产；富有成果
high-tech|n. 高科技；adj. 高技术的
intellectual|adj. 智力的；明智的；有才智的；n. 知识分子
semi-automatic|adj. 半自动的
user friendly|adj. 易使用（理解，操作）的；人性化的
identical|adj. 相同的；同样的
alike|adj. 相同的；相像的；adv. 相同地；相像地
duplicate|v. 复制；复印；再做一次；n. 副本；复制品；完全一样的东西；adj. 复制的；副本的；完全一样的
dissimilar|adj. 不相似的；不一样的；不同的
distinct|adj. 有区别的；清晰的；明显的
at least|phrase. 至少；不少于；起码
ailment|n. 轻病；小恙
fraternal|adj. 兄弟（般）的；友爱的；异卵双生的
vulnerability|n. 脆弱性；弱点；致命性
vulnerable|adj. 脆弱的；易受伤的
root|n. 根；根源；v. 生根
with respect to|phrase. 考虑到；关于；至于
heredity|n. 遗传；遗传特征
hereditary|adj. 遗传的；遗传性的；世袭的
account|n. 账户；叙述；账目；v. 说明；占…
ascribe|v. 把…归因于
attribute|v. 由…引起；把…归因于；认为是…创作的；n. 属性；品质；特征；定语
be credited to ...|phrase. 归功于；归因于
causality|n. 因果关系；因果律
cause|n. 原因；理由；理想；事业；v. 导致；引起
derive|v. 起源；来自；源自；得到
for the sake of|phrase. 为了…
gratuitous|adj. 无故的；无必要的；无偿的；免费的
unwarranted|adj. 不合理的；没有根据的；无端的
justification|n. 辩护；正当的理由
justify|v. 替...辩护；证明...正当
reason|n. 原因；理由；理性；v. 推理；推断；讲道理；思考
result from|phrase. 由...产生；产生于
result in|phrase. 导致
constituent|adj. 组成的；构成的；立宪的；n. 成分；要素；选区内的选民
fragment|n. 碎片；断片；片段；v. （使）成碎片；（使）分裂
holistic|adj. 整体论的；整体主义的
integral|adj. 构成整体所必需的；完整的；积分的；n. 积分；整体
integrate|v. （使）合并；（使）融入；积分
integration|n. 结合；整合；一体化
disintegrate|v. 瓦解；解体；分裂
integrity|n. 完整；正直；诚实
panoramic|adj. 全景的
partial|adj. 部分的；偏袒的
partially|adv. 部分地；在某种程度上；局部地
portion|n. 部分；一份；v. 分配；把…分成份额
section|n. 部分；部门；章节
segment|n. 部分；片段；v. 分割
blood type|phrase. 血型
chromosome|n. 染色体
color-blindness|n. 色盲；色盲症
decode|v. 解码；译解；译码
deletion|n. 删除；缺失；删去
DNA sequence|phrase. 基因序列；DNA序列
dominant heredity|phrase. 显性遗传
family tree|phrase. 家谱
gene|n. 基因
genetic|adj. 基因的；遗传学的
genetics|n. 遗传学
genome|n. 基因组；染色体组
mutation|n. 转变；突变；变异
recessive inheritance|phrase. 隐性遗传
substitution|n. 替换；代替；替代
substitute|v. 替代；n. 代用品；代替物
substituted|adj. 代替的；“substitute”的过去式和过去分词；v. 代替
transgene|n. 转基因
transgenic|adj. 转基因的
perhaps|adv. 或许；可能
graphic|adj. 生动的；图表的；n. 图表
lifelike|adj. 逼真的；生动的；栩栩如生的
vivid|adj. 生动的；鲜艳的；栩栩如生的
pictorial|adj. 有图画的；图示的；n. 画报
vague|adj. 含糊的；不明确的
obscure|adj. 昏暗的；不清楚的；无名的；v. 使模糊；使隐晦；使费解
expression|n. 表达；表情；措辞
self-awareness|n. 自我意识
in general|phrase. 通常；大体上；一般而言
rage|n. 盛怒；风靡一时；v. 发怒；怒斥；（战斗、争论）激烈进行；（暴风雨）肆虐
annoyance|n. 烦恼；可厌之事
annoyed|adj. 恼怒的；气恼的；v. 使恼怒；使气恼；“annoy”的过去式和过去分词
be angry with|phrase. 生…的气；对…感到气愤
be beside oneself with rage|phrase. 大发雷霆；怒气冲冲；气的发疯
blow up|phrase. 使充气；爆炸；发怒；夸大
enrage|v. 激怒；使暴怒
exasperate|v. 使恼怒；使加剧
flip out|phrase. 精神失常；发疯
fret|v. 烦躁不安；苦恼
fume|n. 烟雾；烟气；愤怒；烦恼；v. 用烟熏；冒烟；大为生气
furibund|adj. 暴怒的；愤怒的
furious|adj. 狂怒的；暴怒的；激烈的
irate|adj. 发怒的；生气的
fierce|adj. 凶猛的；凶狠的
turbulent|adj. 狂暴的；骚动的；动荡的；汹涌的
meek|adj. 温顺的；驯服的
calm|v. （使）平静；（使）镇定；adj. 平静的；镇静的；n. 平静
unperturbed|adj. 泰然自若的
fury|n. 狂怒；狂暴；暴怒
get worked up|phrase. 对…激动；特别生气；不开心
grouchy|adj. 爱发牢骚的；脾气坏的；不悦的； 愠怒的
in a temper|phrase. 在盛怒之下；发着脾气
incense|n. 熏香；熏香的烟；v. 使愤怒；激怒
indignant|adj. 愤慨的；义愤的
indignation|n. 愤怒；愤慨；义愤
inflame|v. 激怒；加剧；发炎
infuriate|v. 激怒；使狂怒
irritate|v. 激怒；使急躁；使疼痛
lose one's temper|phrase. 发脾气；发怒
make one's blood boil|phrase. 使某人火冒三丈
make sb. nuts|phrase. 使某人发疯
nettlesome|adj. 易怒的；烦人的
out of patience|phrase. 失去耐心；忍无可忍
outrage|n. 暴行；愤怒；愤慨；v. 激怒；使震怒
provoke|v. 激怒；激起
anger|n. 愤怒；怒气
provoking|adj. 令人生气的；惹人恼火的；v. 激起；激怒；；“provoke”的现在分词
wrath|n. 愤怒；怒气；狂怒
average|adj. 平均的；普通的；n. 平均数；平均水平；v. 平均为…
ordinary|adj. 普通的；平常的；一般的
catholic|adj. 普遍的；广泛的；天主教的；n. 天主教徒
commonplace|adj. 普通的；平庸的；n. 平凡的事
diffusive|adj. 扩散的；散布性的
exhaustive|adj. 详尽的；彻底的；无遗漏的
thorough|adj. 彻底的；完全的；详尽的
hackneyed|adj. 陈腐的；陈词滥调的；老生常谈的
mediocre|adj. 平庸的；平凡的；普通的
mediocrity|n. 平凡；平庸
mostly|adv. 主要地；大部分；通常
pervasive|adj. 遍布的；弥漫的
prevalent|adj. 普遍的；流行的；盛行的
rare|adj. 稀少的；珍奇的
uncommon|adj. 不常有的；罕见的
prevalence|n. 流行；盛行；普遍
routine|n. 常规；例行公事；adj. 常规的；例行公事的
regular|adj. 规则的；有规律的；经常的；常见的；分量适中的；n. 正规军； 主力（或正式）队员； 常客
ubiquitous|adj. 到处存在的
ubiquity|n. 无处不在；普遍存在
unanimous|adj. 全体一致的；一致同意的；无异议的
agreeing|v. 同意；“agree”的现在分词
unanimously|adv. 全体一致地；无异议地
usually|adv. 通常；一般
widespread|adj. 流传甚广的；分布广的
geography|n. 地理；地理学
affect|v. 影响；感动；假装
influence|n. 影响（力）；有影响的人或物；v. 影响
locate|v. 位于；查找…的地点；确定…的位置；使坐落于
prevent|v. 防止；预防；妨碍
preventative|adj. 预防性的；n. 预防措施；预防药
prevention|n. 阻止；妨碍；预防
preventive|adj. 预防性的；n. 预防措施；预防药
consequence|n. 后果；结果
contribute|v. 捐献；投稿；贡献；促成
contribution|n. 贡献；捐助物；投稿；稿件
disempower|v. 使失去权力或影响
effective|adj. 有效的；生效的
immune|adj. 免疫的；有免疫力的；不受影响的
resistant|adj. 抵抗的；有抵抗力的
invulnerable|adj. 不会受伤害的；攻不破的；固若金汤的
immunity|n. 免疫力；豁免；免除
influential|adj. 有影响力的
interplay|v. 相互作用；n. 相互作用
interrelationship|n. 相互关联；相互联系
pliable|adj. 易弯曲的；柔韧的；易受影响的
predispose|v. 使预先有倾向；使易接受；使易于患（病）
predisposition|n. 倾向；趋势；易患病的体质
predominant|adj. 主导的；支配的；占有优势的；显著的；主要的
susceptibility|n. 感受性；易感性
susceptible|adj. 易受影响的；易动感情的
curative|adj. 医疗的；治疗的；n. 药品
heal|v. 复原；治愈
healing|n. 治疗；愈合；疗癒；adj. 痊愈中的；医治用的；v. 复原；治愈；“heal”的现在分词
psychiatric|adj. 精神病的；精神病学的
recover|v. 恢复；重新获得；复原
remedy|n. 疗法；纠正办法；v. 纠正；治疗
surgery|n. 外科手术
surgical|adj. 外科的；外科手术的
therapist|n. 治疗学家；治疗专家；临床医学家
therapy|n. 治疗；疗法
alcoholism|n. 酗酒；酒精中毒
anemia|n. 贫血（症）
angina|n. 心绞痛；咽峡炎
appendicitis|n. 阑尾炎；盲肠炎
arthritis|n. 关节炎
asthma|n. 哮喘
bronchitis|n. 支气管炎
bunion|n. 𧿹囊炎；𧿹趾囊肿
cancer|n. 癌；癌症
chickenpox|n. 水痘
coma|n. 昏迷
concussion|n. 脑震荡
cough|n. 咳嗽；v. 咳嗽
diabetes|n. 糖尿病；多尿症
dislocation|n. 关节错位；脱臼；混乱
dysmenorrhoea|n. 痛经
enteritis|n. 肠炎
fracture|n. 破裂；骨折；v. 使断裂；使骨折；使分裂
haemorrhage|n. 体内大出血；严重流失；v. 体内大出血；（使）严重流失
hepatitis|n. 肝炎
hypertension|n. 高血压；过度紧张
hypotension|n. 血压过低
leukemia|n. 白血病
malaria|n. 疟疾
pharyngitis|n. 咽炎
pneumonia|n. 肺炎
rabies|n. 狂犬病
smallpox|n. 天花；天花病毒
tetanus|n. 破伤风
tracheitis|n. 气管炎
tuberculosis|n. 结核病；肺结核
tumor|n. 肿瘤；肿块
similarly|adv. 相似地；类似地
collect|v. 收集
beyond|prep. 超出
enlarge|v. 扩大；放大
develop|v. 发展；形成；制订
development|n. 发展；开发
undeveloped|adj. 未开发的；不发达的
developing|adj. 发展中的；v. 发展；发育；“develop”的现在分词
interest|n. 兴趣；利益；利息；v. 使产生兴趣
accumulate|v. 积累
accumulation|n. 积累；累积物
amass|v. 积累；积聚；收集
attend|v. 出席；参加；照料；注意；专心
collection|n. 收集物；收藏品
congregate|v. （使）集合；（使）聚集
convene|v. 召集；集合；开会
gather|v. 聚集；集合
party|n. 聚会；政党
amplify|v. 放大，扩大；增强；详述
deflate|v. 放气；紧缩；缩小；挫某人锐气
shrink|v. 收缩；退缩；踌躇不前
augment|v. 增加；增强；扩大
augmentation|n. 增加；增大
broaden|v. 变宽；扩大；开阔
dilate|v. 使扩大；扩大；膨胀；详述
escalate|v. （使）升级；（使）恶化；逐步升高
expand|v. 扩大；膨胀；更充分地阐述
expanding|adj. 扩展的；扩充的；v. 扩大；扩张；更充分地阐述；“expand”的现在分词
expansion|n. 扩张；扩充
expanse|n. 辽阔；广袤
extend|v. 扩展；延长；提供；给予
magnify|v. 放大；扩大；夸大
outstretch|v. 伸开；扩展
sprawl|v. 伸开四肢；蔓延；杂乱无序地拓展；n. 伸开四肢；蔓延；杂乱无序的拓展
swell|v. 膨胀；肿胀
compass|n. 罗盘；指南针
realm|n. 领域；王国
region|n. 地区；区域
regional|adj. 地区的；区域的
scope|n. 范围；领域
spectrum|n. 范围；幅度；光谱；波谱
sphere|n. 球体；范围
territory|n. 领土；领域
territorial|adj. 领土的
zone|n. 地带；地区；v. 分成区
appeal|n. 恳求；呼吁；上诉；吸引力；v. 呼吁；吸引；诉请
accuse|v. 指控；指责
appetite|n. 胃口；食欲；嗜好；爱好
captivate|v. 迷住；迷惑
intrigue|v. 密谋；激起…的兴趣；n. 阴谋诡计；密谋策划
intriguing|adj. 引起兴趣的；引人入胜的；v. 密谋；激起…的兴趣；“intrigue”的现在分词
orient|v. 朝向；确定方向；使适应；n. 东方
contingency|n. 偶然事故；意外事件
feasible|adj. 可行的；行得通的
imaginable|adj. 可想象的；可能的；可想到的
likelihood|n. 可能性
presumably|adv. 推测起来；大概
presume|v. 假设；假定；设想；冒昧
presumable|adj. 可能的；可推测的
probability|n. 概率；可能性；几率
probable|adj. 很可能的
likely|adj. 可能的
suspense|n. 悬疑；焦虑；悬念
suspend|v. 吊；悬；暂停；延缓
suspended|v. 悬浮；暂停；“suspend”的过去式和过去分词
suspender|n. 吊袜带；悬挂用的物体
suspensive|adj. (产生)悬念的；未决定的
distance|n. 距离；远处；v. 保持距离
far|adv. 远；极；adj. 较远的；遥远的
as a whole|phrase. 整体来看；总体上
abut|v. 邻接；毗连
adjacent|adj. 相邻的；邻近的
detached|adj. 分离的；独立的；不带感情的；超然的；v. 脱离；拆卸；分离；“detach”的过去式和过去分词
separate|adj. 分开的；分离的；单独的；v. 分离；隔离
adjoin|v. 毗连；紧挨
adjoining|adj. 贴邻的；毗连的；v. 邻接；毗连；“adjoin”的现在分词
afield|adv. 在田野；在战场上；远离（家园）；在远处
alienate|v. 使疏远；离间；让渡
alienated|adj. 疏远的；不合群的；v. 使疏远；离间；转让；“alienate”的过去式和过去分词
alienation|n. 离间；疏远
border|n. 边界；边疆；v. 和…毗邻；与…接壤
contiguous|adj. 相接的；相邻的；接壤的
distant|adj. 遥远的；远处的；疏远的；冷漠的
estrange|v. 使疏远；使分离
faraway|adj. 遥远的；远方的；恍惚的
nearness|n. 接近；亲密
closeness|n. 亲密；接近；密闭；狭窄
neighbouring|adj. 邻近的；毗邻的
proximity|n. 接近；亲近
ulterior|adj. 较远的；不可告人的；隐秘的
vicinity|n. 附近；周围地区；邻近地区
daze|v. 使发昏；使迷乱；n. 恍惚； 晕眩
downhearted|adj. 消沉的；沮丧的；情绪低落的
exhaust|v. 耗尽；用完；使筋疲力尽；n. 排气管；废气
exhaustion|n. 枯竭；耗尽；筋疲力尽
exhaustible|adj. 可空竭的； 用得尽的
faint|adj. 微弱的；缺少热情的；虚弱的；v. 昏厥
indefatigable|adj. 不知疲倦的；不屈不挠的
intuition|n. 直觉；直觉的知识
listless|adj. 没有活力的；无精打采的
ravenous|adj. 极饿的；极度的
sensation|n. 感觉；知觉；轰动
sensational|adj. 轰动的；耸人听闻的；极好的
sensitive|adj. 敏感的；感情脆弱的；体贴的；善解人意的
sensitivity|n. 敏感性；灵敏度；感受性
sensory|adj. 感觉的；感官的
sensuous|adj. 感觉上的；感官的；（引起）美感的
sentient|adj. 有知觉的；有感觉力的
blueprint|n. 蓝图；计划；设想；v. 为…制蓝图；为…制订计划
centre around|phrase. 以...为中心；集中于
concept|n. 观念，概念
construct|v. 建造；构造；作（几何图）；n. 结构（物）；构想；概念
context|n. 上下文；语境；环境
district|n. 地区；区域；行政区
entertainment|n. 休闲娱乐；款待
entertain|v. 娱乐；使快乐；款待；心存；怀有
make use of|phrase. 使用
pedestrian|n. 行人；步行者；adj. 步行的；呆板的；平淡无奇的
project|n. 计划；方案；项目；课题；v. 预计；计划；投射；突出
purpose|n. 目的；意图
ring road|phrase. 环形道路
site|n. 位置；场所
structure|n. 结构；建筑物；v. 组织；安排
regard|v. 看待；认为；注视；有关；n. 尊敬；致意
comparison|n. 比较；对比
feeble|adj. 虚弱的；衰弱的；无力的
breakdown|n. 崩溃；倒塌；损坏；故障；细目分类
disintegration|n. 崩解；瓦解；分裂
classification|n. 分类；分级
emaciate|v. （使）消瘦；（使）衰弱
emaciated|adj. 瘦弱的；憔悴的；v. （使）消瘦；（使）衰弱 ；“emaciate”的过去式和过去分词
flimsy|adj. 轻而薄的；易坏的；不足信的；n. 复写纸；薄纸副本
fragile|adj. 易碎的；不牢固的；脆弱的
frail|adj. 易损的；易碎的；瘦弱的；不牢固的
unbreakable|adj. 不易破损的；不能违反的；牢不可破的
sturdy|adj. 强健的；坚固的；坚决的
impotence|n. 无效；虚弱；无能为力；阳萎
meagre|adj. 贫乏的；微薄的
pitiful|adj. 令人怜悯的；使人同情的；可怜的
slender|adj. 苗条的；微薄的
slenderness|n. 苗条；细长
slight|adj. 轻微的；微小的；细瘦的；n. 轻慢；v. 轻视
slightly|adv. 稍微；略微；瘦小地
tender|adj. 嫩的；温柔的；纤弱的；疼痛的；n. 看管者；投标；补给船；煤水车；v. 正式提出；投标
weaken|v. 削弱；变弱
weakness|n. 软弱；弱点；嗜好
firm|n. 公司；商行；adj. 坚固的；结实的
lusty|adj. 精力充沛的；生气勃勃的；健壮的
potent|adj. 强有力的；有效的
robust|adj. 强健的；强壮的；结实的
robustness|n. 坚固性；鲁棒性
robustly|adv. 强健有力地
healthy|adj. 健康的；健壮的
delicate|adj. 微妙的；易碎的；脆弱的；精致的
stocky|adj. 矮壮的；敦实的
stout|adj. 肥胖的；粗壮的；坚定的；n. 烈性黑啤酒
unyielding|adj. 不屈的；不屈服的；坚硬的
counterintuitive|adj. 违反直觉的
imperceptible|adj. 感觉不到的；极细微的
tactile|adj. 触觉的；能触知的；手感好的
vacuity|n. 空虚；空白
suggest|v. 建议；提出；使想起；暗示
advise|v. 向…提出建议；劝告；通知
propose|v. 提议；计划；求婚；举荐
confess|v. 承认；忏悔
book|n. 书；账簿；v. 预订
opportunity|n. 机会；时机
chance|n. 机会；可能性；冒险
advice|n. 建议；意见
advocate|v. 提倡；主张；n. 提倡者；拥护者；辩护律师
comment|n. 评论；意见；批评；v. 评论；表达意见
commentator|n. 评论员；解说员
counsel|n. 律师；劝告；v. 劝告；建议
judgment|n. 判断；审判；判断力
mention|v. 提到；说到；n. 提及；说起
opinion|n. 意见；看法；观点
proposal|n. 建议；提案；求婚
recommend|v. 建议；推荐
recommendation|n. 推荐；建议
remark|v. 评论；谈论；注意到；n. 评述；言论；注意
remarkable|adj. 值得注意的；显著的；非凡的；不寻常的
submit|v. 提交；屈服
utterance|n. 言辞；言语；言论
verdict|n. 裁决；判决；定论
booth|n. 小亭；临时货摊；隔间
buffet|n. 自助餐；饮食柜台；v. 反复敲打；连续猛击
cancel the reservation|phrase. 取消预约；取消预订
change the reservation|phrase. 更改预订（的房间、座位等）
chef|n. 主厨；厨师
dinner jacket|phrase. 无尾礼服上衣；晚礼服上衣
dress code|phrase. 着装规范
enjoy a good reputation|phrase. 享有良好的声誉
entree|n. 入场许可；主菜
in advance|phrase. 提前；预先
in the corner|phrase. 在角落
in the lounge|phrase. 在休息室里
keep the table|phrase. （为...）留位
name|n. 姓名；名称；v. 命名；提名；说出…的名字
nonsmoking|n. 不抽烟的
pay a deposit|phrase. 付押金；交定金
private room|phrase. 包间；雅座；单人间；私人房间
reserve ahead of time|phrase. 提前预留时间
restaurant|n. 餐厅；餐馆
smoking area|phrase. 吸烟区
table for two|phrase. 双人桌；两人座
time|n. 时间；倍；次数；时期；v. 计时；安排时间；adj. 时间的；定时的；分期的
under the name of|phrase. 以…的名义
VIP room|phrase. 贵宾室
wait for a table|phrase. 等桌位；等空座
wait time|phrase. 等待时间
window|n. 窗口；窗户
with a fine view of|phrase. 带有优美景色的（房间）；可以欣赏美景的...
babysit|v. 替人临时照看（小孩）
baggage|n. 行李
dwell|v. 居住；栖身；沉湎于
furniture|n. 家具
hurdle|n. 跨栏；障碍；难关；v. 越过障碍；克服
litter|n. 垃圾；杂物；一窝小崽；担架；v. 乱扔；乱丢杂物
outing|n. 远足；郊游；短途旅行；v. 使熄灭；揭露；驱逐；“out”的现在分词
regimen|n. 养生之道
residency|n. 居住；定居；驻留期；住院医生实习期
rubbish|n. 垃圾；废物
trash|n. 垃圾；无价值的东西；v. 丢弃；损坏；诋毁
singe|v. （使）烧焦；（使）烫糊
sojourn|n. 旅居；逗留；v. 旅居；逗留
sustenance|n. 食物；营养；维持生计
tease|v. 取笑；戏弄；挑逗；梳理（毛、麻等）；n. 爱嘲弄他人的人；戏弄
kid|n. 小孩；v. 哄骗；开玩笑
toy|n. 玩具；v. 玩弄
ancestral|adj. 祖先的；祖传的
tortoise|n. 乌龟
settle|v. 定居；安顿；解决
settler|n. 移民者；殖民者
settlement|n. 解决；协议；定居（过程）；定居点
adapt|v. 适应；改编
unique|adj. 唯一的；独特的
uniqueness|n. 唯一性；独特性
subspecies|n. 亚种
alligator|n. 短吻鳄；鳄鱼皮革
amphibian|n. 两栖动物
amphibiology|n. 两栖动物学
bullfrog|n. 牛蛙
camouflage|v. 伪装；掩饰；n. 伪装；掩饰
chameleon|n. 变色龙；见风使舵的人
cobra|n. 眼镜蛇
crawl|v. 爬；爬行
creep|v. 爬行；匍匐；蹑手蹑脚地走；汗毛直竖；n. 讨厌鬼；马屁精
crocodile|n. 鳄鱼
frog|n. 青蛙
lizard|n. 蜥蜴
python|n. 大蟒蛇；巨蟒
regenerate|v. 再生；重建；使复兴；adj. 再生的；革新的；改过自新的
regeneration|n. 再生；重建
salamander|n. 蝾螈
serpent|n. 大蛇；阴险毒辣的人
shed|n. 棚屋；v. 摆脱；去除；使脱落
skin|n. 皮肤；毛皮；外皮；v. 剥皮；削皮
snake|n. 蛇；v. 蛇行；曲折前行
tadpole|n. 蝌蚪
tail|n. 尾巴；尾随者；v. 跟踪
terrestrial|adj. 陆地的；地球的；类似地球的；陆栖的
toad|n. 蟾蜍；癞蛤蟆；讨厌的人
turtle|n. 龟；海龟
barrenness|n. 不孕症；荒芜
biont|n. 生物
biosphere|n. 生物圈；生物界
deforestation|n. 采伐森林；森林开伐
desertification|n. 沙漠化；荒漠化
eco-environment|n. 生态环境
ecosystem|n. 生态系统
environmental|adj. 环境的；有关环境的
forestation|n. 造林；森林管理
hydrosphere|n. 水圈
interactional|adj. 相互作用的；交互式的
interrelation|n. 相互关系；相互联系
jungle|n. 丛林
lithosphere|n. 岩石圈
pedosphere|n. （地球的）土壤圈；土界
rejuvenation|n. 更新
shield|n. 盾牌；防护物；v. 遮挡；防护
surroundings|n. 环境；围绕物；“surrounding”的复数
transpiration|n. 蒸腾作用
uninhabited|adj. 无人居住的
acclimatize|v. 使适应（新气候或环境）
accommodation|n. 住处；工作场所；停留处；膳宿；（交通工具内的）空间
adjust|v. 调整；使适合；使适应
compatible|adj. 兼容的；可和谐共存的
condition|n. 状态；条件；环境；v. 使适应；影响；保养
conform|v. 符合；顺应；遵从；（使）一致
flexibility|n. 弹性；灵活性；柔韧性
reorient|v. 重新定位；使适应；改变方针；调整
resilience|n. 弹性；复原力；适应力；豁达
socialize|v. 使社会化；进行社交活动；与人交往
specialization|n. 专门化；特殊化
continuous|adj. 继续的；连续的
continuously|adv. 连续地；不断地；连续不断地
reckless|adj. 鲁莽的；不计后果的
rash|n. 疹子；爆发；同时大量出现的事件；adj. 鲁莽的；轻率的
synthetic|adj. 合成的；人造的；综合的
synthetically|adv. 综合地；合成地
chemical|n. 化学品；adj. 化学的
counter-productive|adj. 产生相反结果或效果的
asymmetric|adj. 不对称的；不均¤的
effectual|adj. 有效的；奏效的
efficacy|n. 功效；效力
invalid|adj. 无效的；作废的；n. 病弱者；伤残者
oblique|adj. 斜的；间接的；不直截了当的
overarch|v. 在...上做拱形；成拱形
unrequited|adj. 没有回报的；无报酬的；有仇未报的；单方面的
validate|v. 使生效；证实
impotent|adj. 无力的；虚弱的；阳痿的
unfounded|adj. 无事实根据的
abdomen|n. 腹部
ant|n. 蚂蚁
antenna|n. 触角；天线
tentacle|n. 触角；触须；触手
arthropod|n. 节肢动物；adj. 节肢动物的
bee|n. 蜜蜂
black widow spider|phrase. 黑寡妇蜘蛛
bumblebee|n. 大黄蜂
butterfly|n. 蝴蝶
centipede|n. 蜈蚣；百足虫
dragonfly|n. 蜻蜓
firefly|n. 萤火虫
fly|v. 飞翔；飞行；n. 苍蝇
ladybug|n. 瓢虫
scorpion|n. 蝎子
sting|v. 刺；刺痛；n. 刺；刺痛
blend|v. 混合；配合；融合
compound|n. 化合物；大院；adj. 复合的；混合的；v. 使复杂化；加重
fuse|n. 保险丝；导火线；引信；v. 由于保险丝烧断而电路不通；熔接；结合
merge|v. 合并；混入；融合；渐渐消失
divide|v. 分开；分隔；除以
split|v. 分开；分裂；n. 划分；分歧；裂缝
mingle|v. 使相混；使联结；交际
mixture|n. 混合物；混合
synthesis|n. 综合；合成；综合体
alchemy|n. 炼金术；魔力
alkali|n. 碱；强碱
alloy|n. 合金；v. 把…铸成合金
ammonia|n. 氨；氨水；氨气
calcium|n. 钙
carbon|n. 碳；复写纸
derivative|n. 派生物；衍生物；adj. 派生的；缺乏创意的
helium|n. 氦
hydrate|n.  水合物；氢氧化物；v. （使）成水合物
hydrocarbon|n. 烃；碳氢化合物
impurity|n. 不纯，不洁；杂质；不纯的东西
intermediary|n. 中间人；调解人；adj. 中间的；媒介的
iodine|n. 碘
ion|n. 离子
isotope|n. 同位素
limestone|n. 石灰岩；石灰石
metal|n. 金属
metalloid|n. 准金属（化学性质上表现出金属和非金属两种性质）
methane|n. 甲烷；沼气
nitrogen|n. 氮
oxygen|n. 氧；氧气
particle|n. 微粒；粒子
plastic|n. 塑料；adj. 塑料的；可塑的；不自然的
silica|n. 硅石；二氧化硅
silicon|n. 硅
sulfur|n. 硫（磺）
biochemistry|n. 生物化学
bleach|v. 漂白；使变白；n. 漂白剂
catalysis|n. 催化作用；触媒作用
caustic|adj. 腐蚀性的；苛性的；尖酸刻薄的；n. 腐蚀剂
corrode|v. 腐蚀；侵蚀
decay|v. 腐烂；衰退；n. 腐烂；衰落
decomposition|n. 分解；腐烂
dye|v. 给...染色 ；n. 染料
erode|v. 侵蚀；腐蚀；逐渐丧失；削弱
erosion|n. 腐蚀；侵蚀
explode|v. （使）爆炸；爆发
explosive|n. 炸药；爆炸物；adj. 爆炸的
hydronic|adj. 液体循环加热（或冷却）的
ignite|v. 点燃；使燃烧；激起
polymerization|n. 聚合
reagent|n. 试剂；试药；反应物
rot|n. 腐烂；腐败；v. （使）腐烂
rotten|adj. 腐烂的；腐败的
scorch|v. 烤得变色；（使）烧焦
sear|v. 烤焦；烧灼；adj. 烧焦的；枯萎的；n. 烙印；焦痕
solubility|n. 溶度；溶性；可解决性；可解释性；溶解性
solvent|adj. 有溶解力的；有偿付能力的；n. 溶剂；解决方法
stale|adj. 不新鲜的；陈腐的
tint|n.  色彩；浅色；染发剂；v. 给...染色
laughter|n. 笑声；笑
tap|n. 水龙头；轻拍；轻敲；轻击；v. 轻拍；轻敲；利用；提取
expressive|adj. 表达的；富有表情的
machinery|n. 机械；机械（总称）
emotion|n. 情绪；情感
motor|n. 马达；发动机；机动车
circuit|n. 回路；环行；电路；巡回；v. 环行
vocalisation|phrase. 发声
amused|adj. 被逗乐的；v. 逗乐；娱乐；消遣；“amuse”的过去式和过去分词
amusing|adj. 逗人笑的；有乐趣的；好笑的；v. 逗乐；娱乐；消遣；“amuse”的现在分词
beaming|adj. 喜气洋洋的；愉快的；耀眼的；v. 照耀；“beam”的现在分词
blessed|adj. 幸福的；受祝福的；神圣的；v. 祝福；保佑；“bless”的过去式和过去分词
bliss|n. 无上幸福；极乐
blithe|adj. 无忧无虑的；愉快的
blithesome|adj. 欢乐的；愉快的
brighten|v. 使变亮；使生辉；使有希望；使快活
delight|n. 高兴；快乐；v. 使高兴；使愉快
delightful|adj. 令人愉快的；令人高兴的
ecstasy|n. 狂喜；摇头丸；入迷
ecstatic|adj. 狂喜的；欣喜若狂的
elation|n. 兴高采烈；得意
enrapture|v. 使狂喜
exaltation|n. 得意；兴奋
exalt|v. 赞扬；提升；加强
exalted|adj. 高位的；高尚的；欣喜的；v. 赞扬；提升；加强；“exalt”的过去式和过去分词
excitement|n. 兴奋；激动
exhilaration|n. 高兴；愉快；兴奋
exhilarate|v. 使高兴；使振奋
exult|v. 狂喜；欢跃
exultant|adj. 狂喜的；欢跃的
gleeful|adj. 愉快的；欣喜的；幸灾乐祸的
grin|v. 咧嘴而笑；n. 咧嘴而笑
hilarious|adj. 非常滑稽的
intoxicate|v.  使中毒；使醉；使 ...陶醉
intoxication|n. 喝醉；陶醉；中毒
joyous|adj. 充满快乐的；使人高兴的
jubilant|adj. 欢腾的；欢欣鼓舞的
merry|adj. 欢乐的
merrily|adv. 高兴地；愉快地
mirth|n. 欢乐；欢笑
overjoyed|adj. 充满喜悦的；大喜的；v. 使大喜；“overjoy”的过去式和过去分词
pleasing|adj. 令人高兴的；令人满意的；v. 使欢喜；取悦；“please”的现在分词
rapture|n. 狂喜；非常高兴；v. 使…狂喜
ravish|v. 强奸；抢夺；使着迷
rejoice|v. 欢喜；高兴；喜悦
amorous|adj. 色情的； 多情的； 爱情的
compunction|n. 良心的责备；后悔；悔恨
contrite|adj. 深感懊悔的；痛悔的；悔悟的
penitential|adj. 后悔的；赎罪的；n. 悔罪书；忏悔者
repentance|n. 悔悟；悔改；悔恨
sentimental|adj. 感伤的；感情的；多愁善感的
commiserate|v. 同情；怜悯
consolation|n. 安慰；慰藉
empathetic|adj. 移情作用的
effusive|adj. 溢于言表的；感情奔放的
endearment|n. 表示爱慕的话语；亲热的表示
enviable|adj. 令人羡慕的；引起妒忌的
fondness|n. 喜欢；宠爱；溺爱
inclination|n. 倾斜；倾向；意向
nostalgia|n. 怀恋；怀旧；乡愁
fraternize|v. 亲如兄弟；友善交往；和敌兵亲善
impassive|adj. 无感情的；冷漠的
profane|adj. 亵渎的；不敬神的；世俗的；v. 亵渎神灵；亵圣
adjust oneself|phrase. 调整
attractive personality|phrase. 人格魅力
be adept in|phrase. 擅长
convincing|adj. 令人信服的；有说服力的；v. 说服；使确信；“convince”的现在分词
convince|v. 说服；使确信
cooperative|adj. 合作的；协作的；n. 合作社
incooperative|adj. 不愿意合作的
generous|adj. 慷慨的；大方的
generosity|n. 慷慨；宽宏；大方
greeting|n. 问候；迎接；致意；v. 问候；打招呼；迎接；“greet”的现在分词
informal|adj. 非正式的；不拘礼节的
intelligent|adj. 有才智的；聪明的；明智的
intelligence|n. 智力；才智；情报
interpersonal relationship|phrase. 人际关系
keep promise|phrase. 信守诺言
moderate|adj. 中等的；适度的；温和的；稳健的；v. （使）缓和；节制；n. 温和派人士
networking skill|phrase. 建立人际关系
punctual|adj. 准时的
punctuality|n. 准时
relationship network|phrase. 关系网
reliable|adj. 可靠的；可信的
trustworthy|adj. 可信赖的；可靠的
sociable|adj. 好交际的；友善的；合群的
unsociable|adj. 不爱交际的；不善于社交的
tolerant|adj. 宽容的；容忍的
poll|n. 民意调查；v. 获得（选票）；做民意调查
polling|n. 投票；民意测验；v. 做民意测验；获得 ... 票；“poll”的现在分词
nurture|n. 养育；教养；培育；v. 养育；培养；给予营养
decline|v. 下降；衰退；谢绝；婉拒；n. 下降；衰退；婉拒
recline|v. 躺；靠在；向后倾斜（坐椅）
incline|v. 倾斜；倾向；n. 斜坡
factor|n. 因素；要素；因数；代理人；倍数；系数；v. 把…因素包括进去；分解成因子；做代理商（或管家）
disjunction|n. 分离；分裂；脱节
perception|n. 感知；看法；洞察力
perceptible|adj. 可察觉到的；看得出的；可感知的
perceptive|adj. 观察敏锐的；有洞察力的
reality|n. 现实；事实
breed|v. 饲养；交配繁殖；n. 品种
cultivate|v. 培养；栽培
cultivation|n. 栽培；种植；培养
cultural|adj. 文化的
foster|v. 培养；助长；抚养
fosterling|n. 养子
fosterer|n. 抚养人
nourish|v. 滋养；培养；养育；怀有
conduce|v. 有助于；导致
generation|n. 代；辈；产生
generator|n. 发电机；发生器
induce|v. 诱使；导致；劝说
inducement|n. 引诱物；诱因；动机
inducible|adj. 可诱导的；可导致的
trigger|n. 触发；触发器；扳机；诱因；v. 触发；引起；发动
stimulus|n. 刺激物；促进因素；激励因素
initiate|v. 开始实施；发起；向…传授
factual|adj. 根据事实的；真实的
literally|adv. 字面上；逐字地；确实地
practically|adv. 实际上；几乎；简直
virtually|adv. 几乎；实际上；事实上；差不多
affiliate|v. 隶属于；并入；加入；n. 分公司；附属机构
anarchism|n. 无政府主义
authoritative|adj. 权威性的；命令式的
authority|n. 权威；权威人士；权力；当局；官方机构
autonomy|n. 自治；自主权；自治权
ballot|v. 进行无记名投票 ；n. 无记名投票
centralize|v. 集中；形成中心；中央集权
commission|n. 委员会；佣金；v. 委托；委任
committee|n. 委员会
confederacy|n. 同盟；联盟；联邦
confederate|adj. 同盟的；联合的；n. 同盟者；同伙；合谋者；v. （使）结盟；（使）联合
congress|n. 代表大会；议会；国会
dictatorial|adj. 独裁的；专断的
dictatorship|n. 独裁；专政；独裁政府；独裁国家
dispensation|n. （尤指宗教领袖给予的）豁免；特许；分配；制度
domain|n. 领地；范围；领域
area|n. 面积；区域
field|n. 田地；领域；场地；运动场；v. 处理，应付（问题、电话等）
election|n. 选举；当选
embargo|n. 禁止贸易令；禁运；v. 禁止…的贸易；禁运
factious|adj. 派系的；与派系相关的；好争论的
ideology|n. 意识形态；思想体系
ignominy|n. 耻辱；屈辱；不名誉
indignity|n. 侮辱；侮辱性言行
kingdom|n. 王国
league|n. 联盟；同盟；v. （使）结盟
parade|n. 游行；阅兵；v. 游行；阅兵
partisan|adj. 偏袒的；党派性的；n. 强烈支持者；党羽；游击队员
petition|v. 请求；请愿；祈求；n. 请愿书；祈求；诉状
privilege|n. 特权；荣幸；v. 给予特权；特殊对待
procession|n. 行列；队伍
regime|n. 政权；管理制度
rejection|n. 拒绝；否决；拒斥
sanction|n. 批准；允许；认可；制裁；处罚；v. 批准；认可；制裁；处罚
sanctionist|n. 制裁国
scandal|n. 丑闻；丑行
self-government|n. 自治；政治独立；自制；克己
senate|n. 参议院
sovereign|n. ¸高统治者；君主；元首；adj. 独立自主的；拥有¸高统治权的
unconventional|adj. 不合常规的；不符合惯例的；不寻常的
veto|n. 否决；否决权；v. 否决
vote|n. 选票；表决；得票数；v. 投票；选举
soil|n. 土壤
fertility|n. 肥沃；丰产；繁殖力；生育力
fertilizer|n. 肥料
pesticide|n. 杀虫剂；除害药物
growth|n. 生长；增长
algae|n. 海藻；藻类
increase|n. 增加；增长；v. 增加；增多
run-off|phrase. 流失；决赛，决胜选举
anopheles|n. 疟蚊；按蚊
beetle|n. 甲虫
biocenosis|n. 生物群落
bug|n. 小虫子；细菌；漏洞；窃听器；v. 烦扰；窃听
cabbage worm|phrase. 卷心菜虫
cockroach|n. 蟑螂
cricket|n. 板球；蟋蟀
flea|n. 跳蚤
grasshopper|n. 蝗虫；蚂蚱
locust|n. 蝗虫
hazardous|adj. 危险的；有害的
horsefly|n. 虻；马蝇
insect|n. 昆虫
insecticide|n. 杀虫剂；杀虫药
integrated pest management|phrase. 害虫综合治理；综合虫害管理
larva|n. 幼虫；幼体
louse|n. 虱子；寄生虫；卑鄙的家伙；v. 办砸；除虱子
mosquito|n. 蚊子
moth|n. 蛾；蛀虫
pest|n. 害虫
rootworm|n. 根虫
silkworm|n. 蚕；桑蚕
spider|n. 蜘蛛
termite|n. 白蚁
vermin|n. 害虫；害兽；害鸟；体外寄生虫
wasp|n. 黄蜂；胡蜂
additive|n. 添加物；添加剂；adj. 添加的
cancer-causing chemical|phrase. 致癌化学物质
communicable|adj. 可传达的；会传染的
concoction|n. 混合物；调制品；捏造
contaminant|n. 致污物；污染物
cyanide|n. 氰化物
exacerbation|n. 加重；恶化
exacerbate|v. 使恶化；使加剧
fertilize|v. 使肥沃；使受精；施肥
fertilization|n.  受精；施肥；受精作用
herbicide|n. 灭草剂
herb|n. 药草；香草
pesticide residues|phrase. 农药残留
phosphate fertilizer|phrase. 磷肥
sprayer|n. 喷出水沫者;喷雾器
weed|n. 杂草；野草；v. 除草；铲除
algae pollution|phrase. 藻类污染
aquatic plant|phrase. 水生植物
brown algae|phrase. 褐藻
exuberant|adj. 精力充沛的；热情洋溢的
green algae|phrase. 绿藻
red algae|phrase. 红藻；红藻类
sargassum|phrase. 马尾藻
seaweed|n. 海藻；海草
symbiosis|n. 共生；互惠互利
underwater|adj. 水下的；adv. 在水下
span|n. 间距；时距；跨度；v. 持续；跨越；涉及
century|n. 世纪；百年
stretch|v. 伸展；延伸；持续；n. 伸展；弹性；一段
boundary|n. 分界线；边界
jungle-clad|adj. 丛林覆盖的
clad|adj. 穿衣的；…覆盖的；v. 给...穿衣；供给衣服；“clothe”的过去式和过去分词
volcano|n. 火山
volcanic|adj. 火山的
coral|n. 珊瑚；珊瑚虫；adj. 珊瑚色的；红色的
outlier|n. 露宿者
calendar|n. 日历
decade|n. 十年
epoch|n. 时期；时代；纪元；划时代的大事
epochal|adj. 新纪元的；划时代的
era|n. 时代；纪元
leap year|phrase. 闰年
lunar calendar|phrase. 阴历；农历
solar calendar|phrase. 阳历
acidification|n. 酸化
atoll|n. 环礁
blast fishing|phrase. 炸鱼
calcium carbonate|phrase. 碳酸钙
cluster|n. 群；团；簇；v. 聚集
colony|n. 殖民地；群体
community|n. 社区；团体；群落
continental shelf|phrase. 大陆架
crustacean|n. 甲壳动物；adj. 甲壳类的
exoskeleton|n. （昆虫等动物的）外骨骼
fishery|n. 渔场；渔业
fore reef|phrase. 前礁
fringing reef|phrase. 裙礁
marine species|phrase. 海洋物种
mollusk|n. 软体动物
polyp|n. 水螅；息肉
rainforests of the sea|phrase. 海洋热带雨林
reef crest|phrase. 礁脊
sea anemone|phrase. 海葵
secrete|v. 分泌；隐藏；隐匿
secretion|n. 分泌（物）
shoreline protection|phrase. 海岸保护
sponge|n. 海绵动物；海绵块；v. 用海绵揩拭
spongy|adj. 像海绵的；松软多孔的
stony coral|phrase. 石珊瑚
active volcano|phrase. 活火山
caldera|n. 破火山口
char|v. （把…）烧焦；n. 女清洁工；茶
cone volcano|phrase. 锥形火山
crater|n. 火山口；弹坑
bowl-shaped crater|phrase. 碗型火山口
crust|n. 外壳；硬壳；面包皮；地壳
depression|n. 抑郁；沮丧；萧条；凹陷；洼地；低气压区
dormant|adj. 休眠的；蛰伏的；暂停活动的
earthquake|n. 地震
eject|v. 喷射；喷出；驱逐；逐出
erupt|v. 爆发；喷发
eruption|n. 喷发；爆发
extinct volcano|phrase. 死火山
fault|n. 故障；过错；缺陷；断层；v. 发现错误；找出缺点
lava|n. 岩浆；火山岩
lithogenous|adj. 岩成的；造岩的；成结石的
magma|n. 岩浆
magnitude|n. 重要性；巨大；震级
mantle|n. 披风；斗篷； 覆盖物；地幔；v. 覆盖；遮盖
outburst|n. 迸发；爆发；突发
plate|n. 盘子；碟子
seismic|adj. 地震的
shield volcano|phrase. 盾状火山
squirt|v. 喷出；溅迸；注射；n. 水枪；注射器；喷出
stratum|n. 岩层；地层；社会阶层
tectonic plate|phrase. 板块
tremor|n. 震动；震颤
volcanic ash|n. 火山灰
volcanic dome|phrase. 火山穹顶
volcanic dust|phrase. 火山灰
multiplan|phrase. 多计划
insurance|n. 保险
pre-existing|adj. 先已存在的；早已存在的
medical|adj. 医疗的；医术的
abscission|n. 脱落
acupuncture|n. 针刺疗法；v. 对…施行针刺疗法
allergic|adj. 过敏的；反感的
birth control|phrase. 避孕；节育
clinical|adj. 临床的
convalesce|v. 逐步康复；渐愈；复原
convalescent|adj. 康复期的；渐愈的
deliver|v. 交付；递送；为…接生；发表；陈述；予以
delivery|n. 传送；交付；分娩
doctor in charge|phrase. 主治医师
epidemic|n. 流行病；adj. 流行性的
homeopathy|n. 顺势疗法
houseman|n. 男仆
inquiry|n. 调查；询问
leave hospital|phrase. 出院
nurse|n. 护士；保姆；v. 护理；照料；喂奶
recuperate|v. （使）恢复；（使）复原
sanatorium|n. 疗养院；休养地
seclude|v. 隔离；隔绝；隐居
secluded|adj. 僻静的；隐僻的； 退隐的；v. 隔离；隔绝；隐居；“seclude”的过去式和过去分词
ward|n. 病房；病室；选区；v. 监护；守护；挡住
athlete's foot|phrase. 脚癣；足癣
awkward|adj. 尴尬的；笨拙的；别扭的
bald|adj. 秃头的；不加修饰的；赤裸裸的
blind|adj. 瞎的；失明的；v. 使失明；n. 百叶窗
body odor|phrase. 体臭
clumsy|adj. 笨拙的；不灵巧的
colour blindness|phrase. 色盲
congenital heart disease|phrase. 先天性心脏病
deaf|adj. 聋的；充耳不闻的
defect|n. 毛病；缺陷；v. 叛逃；背叛
disabled|adj. 残疾的；无能力的；v. 使残废；使无能力；“disable”的过去式和过去分词
disadvantaged|adj. 贫困的；弱势的；处于不利地位的；v. 使处于不利地位；“disadvantage”的过去式和过去分词
discrimination|n. 区别；辨别；歧视
dull|adj. 愚笨的；枯燥的；感觉迟钝的；无趣的；阴暗的
dwarfism|n. 侏儒症
fool|n. 傻瓜；蠢人；v. 愚弄
gigantism|n. 巨人症；巨大
harelip|n. 兔唇；唇裂
idiot|n. 白痴；笨蛋
impaired|adj. 受损的；出毛病的；有（身体或智力）缺陷的；v. 损害；削弱；“impair”的过去式和过去分词
lame|adj. 瘸的；跛的；站不住脚的；无说服力的；v. 变跛；瘸行
limp|v. 跛行；蹒跚；瘸着走；adj. 无力的；无生气的
malformation|n. 畸形
mute|adj. 哑的；无声的；n. 哑巴；沉默的人；v. 减弱…的声音；adv. 缄默地
obesity|n. 肥胖；肥胖症
sickish|phrase. 像要生病似的；像要吐的；多病的
slothful|adj. 怠惰的；懒散的
torpor|n. 麻木；迟钝；萎靡
comprise|v. 包括；包含；构成；由…组成
embody|v. 体现；使具体化；包含
incarnate|adj. 化身的；人体化的；v. 化身为；体现
embrace|v. 拥抱；包围；囊括；接受；信奉；n. 拥抱
encompass|v. 包含；包围；围绕
inclusive|adj. 包含全部费用；包含的；包容的
inclusively|adv. 全面地
incorporate|v. 合并；并入；包含；组成公司
comprehend|v. 理解；领会；包含
involve|v. 牵涉；包括
involvement|n. 参与；投入；加入；插手
grapple|v. 抓住；扭打；搏斗；努力解决；n. 抓钩；扭打；搏斗
acceptable|adj. 可接受的
heavily|adv. 沉重地；猛烈地
scrutinize|v. 详细检查；仔细察看
sales|n. 销售额；出售；拍卖；销路
marketing|n. 营销；促销；销售活动
marketer|n. 市场商人；市场上的卖主
antibiotic|adj. 抗生的；抗菌的；n. 抗菌素；抗生素
antidote|n. 解毒药；解毒剂
aspirin|n. 阿司匹林（镇痛解热消炎药）
bacterial|adj. 细菌的
be allergic to|phrase. 对…过敏
capsule|n. 胶囊；太空舱；adj. 压缩的；概要的；v. 压缩；简述
clinic|n. 诊所；诊科
clinical trial|phrase. 临床试验
dentist|n. 牙科医生
diagnose|v. 诊断
dispenser|n. 药剂师；配药师；分配者；自动售货机
drop|n. 滴；下落；v. 落下；掉下
drug abuse|phrase. 吸毒；药物滥用
epidemic prevention|phrase. 防疫工作
eye drops|phrase. 眼药水
family doctor|phrase. 家庭医生
herbal|adj. 药草的；草本的
hygiene|n. 卫生；卫生学
illness|n. 病；疾病
injection|n. 注射；注射剂；注入
medication|n. 药物治疗；药物处理
narcotic|n. 麻醉药；镇定剂；致幻毒品；adj. 麻醉的；催眠的
non-drowsy|adj. 不使人困倦的
drowsy|adj. 昏昏欲睡的；困倦的；催眠的
ointment|n. 药膏；油膏；软膏
pain-killer|n. 止痛药；镇痛剂
pediatrician|n. 儿科医生
penicillin|n. 青霉素
pharmaceutical|adj. 制药的；配药的；n. 药物
physician|n. 医生；内科医生
pill|n. 药丸；药片
potency|n. 效力；潜能
powder|n. 粉末；粉；v. 搽粉于；使成粉末
prescription|n. 处方；药方
psychiatrist|n. 精神病学家；精神科医生
surgeon|n. 外科医生
syrup|n. 糖浆；甜而黏稠的汁液
tablet|n. 药片；丸；（刻有文字的）匾；
test result|phrase. 测试结果
to get vaccinated|phrase. 接种疫苗
vitamin|n. 维生素；维他命
wholesome|adj. 健康的；有益身心的
company profile|phrase. 公司简介
conglomerate|adj. 砾岩的；成球状的；结成团块的；n. 砾岩；企业集团；联合大公司；合成物；v. （使）结聚成一团
consortium|n. 财团；协会
corporate culture|phrase. 企业文化
departmental|adj. 部门的；分部的
headquarter|v. 设总部；在…设总部；把…放在总部中
joint venture|phrase. 合资企业
premise|n. 前提；假定；v. 提出...作为前提
state-owned enterprise|phrase. 国有企业
reasoning|n. 推理；推论；v. 推理；推断；讲道理； “reason”的现在分词
replenish|v. （再）装满；添加；补充
ice sheet|phrase. 大冰原；冰盾
latitude|n. 纬度；行动或言论的程度
freedom|n. 自由
liberty|n. 自由
reflect|v. 反射；反映；反省；思考；仔细考虑
reflection|n. 反射；反映；反省；沉思
space|n. 空间；太空；空格；空白；v. 以一定间隔排列
reduce|v. 减少；降低；减量
decrease|v. 减少；降低；n. 减少
warming|n. 暖和；升温；v. （使）变暖；“warm”的现在分词
ocean|n. 海洋；大海
atmosphere|n. 大气；气氛；氛围
atmospheric|adj. 大气的；有…气氛的
constrict|v. 紧缩；束紧；使收缩
contract|n. 合同；契约；v. （使）收缩；订合同；感染
pact|n. 契约；协定；条约
treaty|n. 条约；协议
deduct|v. 扣除
deductible|adj. 可扣除的；可减免的
detract|v. 减损；诋毁；贬低
dwindle|v. 缩小；减少
indent|v. 使呈锯齿状；缩进排版；n. 订货单
lessen|v. 减少；减轻；缩小
narrow|adj. 狭窄的；窄小的；v. 使窄小
narrow-minded|adj. 度量小的；心胸狭窄的；有偏见的
restriction|n. 限制；约束；限定
subtract|v. 减去；扣除
subtraction|n. 减去；减法
anticipated effect|phrase. 预期效果
combustion|n. 燃烧；着火
combustibility|n. 可燃性；燃烧性
Copenhagen Accord|n. 哥本哈根协定
energy consumption|phrase. 能源消耗
exhaust gas|phrase. 尾气；废气
expansion of desert|phrase. 沙漠扩张
extreme weather|phrase. 极端天气
give off|phrase. 发出（蒸汽、光等）
glacier|n. 冰川；冰河
global warming|n. 全球变暖
greenhouse effect|phrase. 温室效应
greenhouse gas|phrase. 温室气体；二氧化碳、甲烷等导致温室效应的气体
heat wave|n. 热浪
heating|n. 加热；采暖；供暖设备；v. 加热；“heat”的现在分词
human activity|phrase. 人类活动
Kyoto Protocol|n. 《京都议定书》
melt|v. （使）融化；（使）熔化
potential problems|phrase. 潜在问题
precipitation|n. 降（雨）量；沉淀；匆促
reduce emission|phrase. 减少排放
rising sea level|phrase. 海平面上升
temperature increase|phrase. 气温升高；温度增高
the warming of global temperature|phrase. 全球气温变暖
Antarctica|n. 南极洲
Arctic|adj. 北极的；n. 北极地区
equator|n. 赤道
hemisphere|n. 半球体；半个球
longitude|n. 经度
meridian|n. 子午线；子午圈；正午；全盛时期
temperate zone|phrase. 温带
the Antarctic|n. 南极洲
tropic|n. 回归线；热带；adj. 热带的
theory|n. 理论；学说
theorize|v. 建立理论；建立学说；推论；推理
theoretical|adj. 理论的
relate|v. 讲；叙述；有关；把…联系起来；认同；理解
relation|n. 关联；联系；亲属
distinguish|v. 区分；使有别于；辨认；使出众
distinguish ... from ...|phrase. 分辨…
discern|v. 辨明；识别；洞悉
inevitable|adj. 不可避免的；必定的
doomed|adj.  命中注定的；v. 注定；判决；“doom”的过去式和过去分词
unavoidable|adj. 无法避免的
inevitably|adv. 不可避免地；必然地
accord|v. 符合；一致；给予；n. 协议；条约；协调
affinity|n. 喜爱；类同；密切关系；亲和力
association|n. 协会；联系；联想
union|n. 联盟；联合；工会
bond|n. 纽带；联系；债券；保释金；协定；v. （使）黏合；相互联结
close|v. 关闭；使接近；adj. 接近的；亲密的；adv. 接近地；紧挨地
collaborate|v. 合作；协作；通敌
collaboration|n. 合作；协作；通敌；勾结
collaborative|adj. 合作的；协力的
complement|n. 补足物；补语；余角；v. 补充；与…相辅相成
concerted|adj. 协定的；共同的
congenial|adj. 情趣相投的；相宜的；合意的
congruity|n. 一致；协调
consensus|n. 一致；共识
unanimity|n. 一致同意；全体赞同
correlate|v. （使）相互关联
dependence|n. 依赖；信赖
dependent|adj. 依靠的；依赖的；n. 依赖他人者；受赡养者；食客；寄人篱下的仆从
displace|v. 取代；移置；免职；迫使…离开家园
fusion|n. 融合；熔合；聚变
hinge|n. 铰链；合页；枢纽；关键；v. 给（某物）装铰链；依…而定
implicate|v. 使牵连其中；涉及；含意；暗示
incompatible|adj. 不兼容；不相配；不调和的
incongruity|n. 不和谐；不协调
incongruous|adj. 不合适的；不相称的；不协调的
intimacy|n. 亲密；亲昵行为
intimate|adj. 亲密的；私密的
irrelevant|adj. 无关紧要的；不相关的
mutual|adj. 相互的；共同的
respective|adj. 各自的；各个的
subsidiary|adj. 辅助的；附属的；次要的；n. 附属事物；附属公司
supplant|v. 取代；排挤掉
sway|v. 摇摆；摇动；影响；n. 摇摆；影响；支配
childhood|n. 童年；幼年
bound up with|phrase. 与…密切相关的
system|n. 系统；体系
systematic|adj. 成体系的；系统的；有条理的
numeration|n. 计算；读数；命数法
imagination|n. 想象；想象力
consider|v. 考虑；思考；认为
consideration|n. 考虑；体贴；报酬
problem|n. 难题；问题
facility|n. 设施；特定场所；特色功能；资质
childhood memories|phrase. 童年记忆
childhood dream|phrase. 童年的梦想；儿时梦想
naive|adj. 幼稚的；天真的；不成熟的
childish|adj. 孩子气的；幼稚的
puerile|adj. 愚蠢的；幼稚的；孩子气的
juvenile|adj. 青少年的；幼稚的；n. 少年
innocent|adj. 无辜的；清白的；无罪的；天真无邪的
conceive|v. 构思；设想；怀孕
conceivable|adj. 可想象得出的；可信的；可能的
envisage|v. 设想；想象；展望
envision|v. 想象；设想
fancy|n. 幻想；想象力；爱好；怪想；adj. 花哨的；昂贵的；新奇的；v. 想象；设想；想要；喜爱
imagine|v. 想象；设想；假想
imaginary|adj. 想象中的；虚构的
imaginative|adj. 有想象力的；富于想象的
unimaginable|adj. 难以置信的；不可想象的
visualize|v. 使可见；使形象化；设想
apt|adj. 易有…倾向的；恰当的；聪明的
aptitude|n. 天资；天赋；才能
attainment|n. 达到；获得
attain|v. 达到；获得
calibre|n. 口径；才干；质量
capacity|n. 容量；容积；能力；身份；地位；资格
competent|adj. 有能力的；胜任的
inefficient|adj. 效率低的；不能胜任的
creativity|n. 创造力；创造
disable|v. 使残废；使无能力
gift|n. 礼物；天赋
inborn|adj. 天生的；先天的；天赋的
inherent|adj. 固有的；内在的；天生的
insightful|adj. 有深刻了解的；富有洞察力的
mentality|n. 智力；心理状态
potential|n. 潜力；adj. 潜在的；可能的
viability|n. 生存能力；发育能力；生活力
connect|v. 连接；接通
connection|n. 连接；关联
correlation|n. 相关；相互关系
relevance|n. 相关性
combine|v. 组合；结合
join|v. 加入；连接
relevant|adj. 相关的；有意义的
mathematics|n. 数学
mathematical|adj. 数学的
appreciate|v. 欣赏；理解；感激；增值
appreciation|n. 欣赏；感激；理解
appreciative|adj. 感激的；欣赏的；表示赞赏的
appreciable|adj. 可觉察的；很可观的
accuracy|n. 精确性；准确度
accurate|adj. 精确的；无误的
algebra|n. 代数
altitude|n. 海拔；高度
arc|n. 弧；弧形物；v. 成弧线
arithmetic|n. 算术
ascending|adj. 上升的；向上的；v. 上升；升高；登高；“ascend”的现在分词
ascend|v. 上升；升高；登高
assumption|n. 假设；假想
calculus|n. （人体内的）结石；微积分学
complementary|adj. 互补的；补充的
congruent|adj. 符合的；一致的；全等的
coordinate|v. 协调；使配合；搭配；n. 坐标；adj. （在句子中）并列的；坐标的
cube|n. 立方体；立方
denominator|n. 分母
deviation|n. 偏离；出轨；背弃
enumerate|v. 列举；枚举
error|n. 错误；差错
even|adv. 甚至；甚至于；adj. 偶数的；平坦的；v. 使平均；使相等；使平坦
odd|adj. 奇怪的；奇数的；不成对的；不经常的；adv. （用于数字后）大约
exponent|n. 阐述者；拥护者；代表者；指数
formula|n. 公式；配方；方案；分子式
hyperbola|n. 双曲线
infinity|n. 无限；无穷
intersect|v. 相交；交叉；横穿
intersection|n. 交叉；相交；十字路口；交叉路口
invariance|n. 不变性；恒常性
logarithm|n. 对数
maximize|v. 使增加至¸大限度；¸大化
multiply|v. 乘；增加；繁殖
numerator|n. （分数中的）分子
pentagon|n. 五边形；五角形
percentage|n. 百分比；百分率
permutation|n. 排列；排列中的任一组数字或文字
power|n. 权力；力量；电源；强国；乘方；幂；v. 给…提供能量；供以动力
progression|n. 进步；进展
quadrant|n. 四分之一圆周；象限；四分仪
quotient|n. 商（数学）；份额；系数
sequence|n. 顺序；次序；系列
slope|n. 斜坡；坡度；v. 倾斜；有坡度
statistics|n. 统计学；统计数字
summation|n. 结论；总结；求和
addition|n. 增加；加法；附加物
combination|n. 组合；结合
dimension|n. 尺寸；维度
dimensional|adj. 维度的；空间的；尺寸的
fraction|n. 小部分；分数
equation|n. 方程式；等式
circumference|n. 圆周；周围；周长
cone|n. 圆锥体；圆锥形物；球果；松球
cylinder|n. 圆柱；圆筒；汽缸
diameter|n. 直径
ellipse|n. 椭圆
geometry|n. 几何学
geometric|adj. 几何（学）的
perimeter|n. 周长；周围，边界
polygon|n. 多边形；多角形
radius|n. 半径；范围
rectangle|n. 矩形；长方形
square|n. 平方；正方形；四方形；广场；v. 使成平方；与...一致；adj. 正方形的；四方形的；成直角的；平方的；adv. 成直角地
symmetry|n. 对称
asymmetry|n. 不对称；不¤称
triangle|n. 三角形；三角形物
negotiate|v. 谈判；协商；通过；越过
range|n. （变化）范围；一系列；山脉；v. 包括（各种不同的人或物）；（在某范围内）变化
ranger|n. 护林员；公园看管人；突击队员
benefit|n. 利益；好处；救济金；v. 有益于；有助于
advantage|n. 优势；好处；有利条件
beneficial|adj. 有益的；有用的
discounted|adj. 已折扣的；v. 打折扣；不全信；不重视；“discount”的过去式和过去分词
private|adj. 私人的
secret|n. 秘密；adj. 秘密的
personal|adj. 个人的；私人的
healthcare|n. 卫生护理；医疗保健
purchase|n. 购买；采购；v. 购买；采购
buy|v. 买；换取；收买；相信
purchaser|n. 买主，购买人
scheme|n. 阴谋；计划；v. 密谋；策划
along with|phrase. 与...在一起；沿着；除此之外，还…
one-off|adj. 一次性的
amusement|n. 娱乐；消遣；乐趣；逗乐
coordination|n. 协调；配合；协作
coordinator|n. 协调者；同等的人（或物）
consultation|n. 咨询；磋商
convention|n. 习俗；大会；协定
meeting|n. 会议；会面；v. 遇见；见面；满足；“meet”的现在分词
conference|n. 大型会议；商讨
intercede|v. 说情；求情；调解
negotiable|adj. 可协商的；可转让的；可通行的
reconcile|v. 使和解；使和好；调和
reconciliation|n. 和解；调和
amuse|v. 逗乐；娱乐；消遣
distraction|n. 分心；注意力分散；娱乐
leisure|n. 空闲；闲暇
leisured|adj. 有闲的；悠闲自在的
pastime|n. 消遣；娱乐
recess|n. 休息；休会；壁龛；壁凹；v. 放入壁龛；休息；休会
recreate|v. 再创造；使再现
recreation|n. 消遣；娱乐
recreational|adj. 娱乐的；消遣的
relaxation|n. 放松；消遣；休息
repose|n. 休息；睡眠；安宁；v. 休息； 长眠；静卧；安置于；将（信赖等）寄托于
slacken|v. 减缓；（使）松弛；懈怠
vacation|n. 假期；度假
entitlement|n. 权益；应得的权利；权利资格
subsidise|v. 以津贴补助
welfare|n. 福利；社会救济
well-being|n. 幸福；安乐；康乐
enthusiast|n. 热心者；热衷于…的人
flight|n. 飞行；航班；鸟群；（阶梯的）一段
fantasy|n. 幻想；奇幻
jet|n. 射流；气流；喷射口；喷气式飞机；v. 喷射
pack|v. 包装；收拾行李；塞满；n. 包裹；小包；一群；（纸牌的）一副
equipment|n. 设备；装备
enable|v. 使能够；使可能
climb|v. 攀爬；爬升
vertically|adv. 垂直地；直立地；竖直地
forwards|adv. 向前地
backwards|adv. 向后；倒着；朝反方向
crazy|adj. 疯狂的；狂热的
devoted|adj. 投入的；忠实的；深爱的；全心全意的；v. 投入；献身；“devote”的过去式和过去分词
fanatic|adj. 狂热入迷的；盲信的；n. 狂热者；盲信者
fanaticism|n. 狂热；盲从
frenetic|adj. 发狂似的；狂乱的
frenzy|n. 狂乱；狂暴；狂怒；v. 使狂乱；使狂怒
furor|n. 狂热；狂怒；轰动
mania|n. 狂热； 癖好；躁狂症
zealotry|n. 狂热；狂热的行为
ardent|adj. 热心的；热情的
ardor|n. 激情；热情
cordial|adj. 热诚的；友好的；n. 甜露酒
enthusiasm|n. 热情；热心；热诚
enthusiastic|adj. 充满热情的；热心的
fervent|adj. 热烈的；强烈的；热情的
fervor|n. 热情；热忱；激情
passionate|adj. 热情的；充满热情的
verve|n. 神韵；活力；激情
zeal|n. 热情；热忱
zealous|adj. 热心的；热情的
zest|n. 兴致；热情；趣味；（用于调味的）柠檬皮；橙皮
ache for|phrase. 同情；渴望；想念
aspire|v. 向往；渴望；追求；立志
crave|v. 渴望；热望；恳求
desirable|adj. 值得要的；令人渴望的；称心如意的
desire|n. 欲望；渴望；v. 渴望；期望
desirous|adj. 渴望的；想要的
desperate for|phrase. 渴望
hunger|n. 饥饿；渴求；v. 使饥饿；渴望
long|adj. 长的；长时间的；adv. 长久地；始终；n. 长时间；长期；v. 渴望；盼望
reverie|n. 幻想；白日梦
yearn|v. 渴望；渴求
yen|n. 渴望；日元；v. 渴望
clockwise|adv. 顺时针方向地；adj. 顺时针方向的
disorientate|v. 使迷失方向；使迷惘
orientate|v. 朝东；定位；适应
uphill|adj. 上坡的；漫长而艰难的；adv. 向山上；朝上坡方向
typical|adj. 典型的；有代表性的
typically|adv. 往往；典型地；常常；有代表性地
high-pitched|adj. 声调高的；声音尖锐的；陡的（屋顶）；激烈
exaggerated|adj. 夸张的；夸大的；言过其实的；v. 夸张；夸大；“exaggerate”的过去式和过去分词
exaggerate|v. 夸张；夸大
exaggeration|n. 夸张；夸大
repetitious|adj. 重复的；一再的
repetition|n. 重复；反复
source|n. 来源；出处；源泉；源头；提供资料者；v. 寻找货源
fascination|n. 迷惑力；魅力
fascinate|v. 强烈吸引住；使着迷
linguist|n. 通晓数国语言的人；语言学家
linguistic|adj. 语言的；语言学的
boast|v. 自夸；夸耀；自豪地拥有
boastful|adj. 自吹自擂的；自夸的
bombastic|adj. 夸大的；言过其实的
brag|v. 吹嘘；自吹自擂；adj. 一流的；极好的
magniloquent|adj. 夸大的；言过其实的
overstate|v. 夸大；言过其实
pretentious|adj. 自命不凡的；自负的；矫饰的
acquaint|v. 使熟悉；使相识
acquaintance|n. 认识的人；相识
ambiguous|adj. 模棱两可的；含糊不清的
apprehend|v. 理解；逮捕
comprehensible|adj. 可理解的；能懂的
comprehension|n. 理解；领悟
evident|adj. 明显的
explicit|adj. 明确的；清楚的
grasp|v. 抓紧；领会；n. 紧抓；领会
ignorance|n. 无知；愚昧
ignorant|adj. 无知的；缺乏知识的
intelligible|adj. 可理解的；明白易懂的；清楚的
unintelligible|adj. 难以理解的；难懂的
incomprehensible|adj. 不能理解的；费解的
tangibly|adv. 可触摸地；可触知地；有形地
tangible|adj. 可触摸的；实际的；有形的；确凿的
intangible|adj. 不可捉摸的；无形的；n. 无形的东西
understandable|adj. 可理解的；可懂的
understanding|n. 理解；了解；v. 理解；明白；懂了；“understand”的现在分词
acquisition|n. 获得；得到的东西；收购
acquire|v. 获得；得到；学会
alphabet|n. 字母表
alphabetical|adj. 字母的；按字母顺序的
first-language acquisition|phrase. 母语习得
language acquisition|phrase. 语言习得
language study|phrase. 语言研究；语言学习
mother tongue|phrase. 母语；本国语；本族语
native language|phrase. 本地话
oral|adj. 口述的；口头的
phonetic|adj. 语音的；语音学的
pronounce|v. 发音；宣告
pronounceable|adj. 可发音的；读得出的
spoken language|phrase. 口语
accost|v. （贸然）上前搭讪；（唐突地）走近谈话
chat|v. 聊天；n. 聊天
coax|v. 哄；用好话劝诱；哄骗
colloquial|adj. 口语的；会话的
confide|v. 吐露；委托；信赖
declaim|v. 慷慨陈词；高声朗诵
dumb|adj. 哑的；沉默的；愚笨的
speechless|adj. 无言以对的；一时语塞的
voiceless|adj. 无声的；清音的
effuse|v. 流出；涌出；扩散
equivocate|v. 含糊其辞；说模棱两可的话
excuse|n. 饶恕；借口；致歉；v. 宽恕；原谅；辩解
gabble|v. 急促而含混不清地说；n. 急促不清的话
gossip|n. 流言蜚语；爱说长道短的人；闲话；v. 散播（流言蜚语）
grumble|v. 发牢骚；抱怨；轰鸣；n. 怨言；牢骚；轰隆声
hearsay|n. 传闻；谣传；道听途说
hoarse|adj. 沙哑的；嘶哑的
hubbub|n. 嘈杂；喧哗声
nonsense|n. 无意义的话；胡说
oration|n. 演说；演讲
outwit|v. 以机智胜过；智胜
rumble|n. 隆隆声；辘辘声；v. 隆隆作响；辘辘行驶
solicit|v. 恳求；征求；（妓女）拉客
psychologist|n. 心理学家；心理学研究者
character|n. 人物角色；性格；特点；文字
undergo|v. 经受；经历；遭受
transformation|n. 转化；转换；改革
meaningful|adj. 意味深长的；有意义的
trait|n. 特性；特点
personality|n. 人格；个性； 名人
adorable|adj. 可爱的；讨人喜欢的
adore|v. 爱慕；敬慕；崇拜
ambitious|adj. 有野心的；有雄心的
ambition|n. 野心；雄心；抱负
aspiring|adj. 有抱负的；有志向的；渴求的；v. 向往；渴望；追求；立志；“aspire”的现在分词
bravery|n. 勇敢；大胆；无畏
brave|adj. 勇敢的；无畏的
brilliant|adj. 光辉的；明亮的；灿烂的；卓越的；极好的
courageous|adj. 勇敢的；有胆量的
courage|n. 勇气；勇敢
daring|adj. 大胆的；勇敢的；v. 敢于；胆敢；“dare”的现在分词
fearless|adj. 无畏的；大胆的
forgiving|adj. 宽恕的；宽大的；仁慈的；v. 原谅；宽恕；“forgive”的现在分词
genial|adj. 亲切的；和蔼的；温暖的
amiable|adj. 和蔼可亲的；亲切友好的
humorous|adj. 幽默的；风趣的
humor|n. 幽默；诙谐；情绪；v. 迁就；迎合
independent|adj. 独立的；自主的
ingenuous|adj. 单纯的；天真的；坦率的
intrepid|adj. 无畏的；勇猛的
intrepidity|n. 无畏；勇猛
perfect|adj. 完备的；完美的；v. 使完美
perfection|n. 完美；完善
quick wit|phrase. 机智
romantic|adj. 浪漫的
romanticism|n. 浪漫主义
spunky|adj. 有胆量的；精力充沛的
arbitrary|adj. 任意的；专横的；武断的
arrogant|adj. 傲慢的；自大的
haughty|adj. 傲慢的；高傲自大的
bad-tempered|adj. 脾气不好的；易怒的
barbaric|adj. 野蛮的；野蛮人的；残暴的
savage|adj. 野性的；凶猛的；荒野的；n. 野蛮人；粗人；凶恶的人；v. 凶狠地攻击；激烈抨击
bossy|adj. 专横的；爱发号施令的；n. 母牛或小牛
conceited|adj. 自负的；骄傲自大的
conceit|n. 自负；骄傲自大
dishonest|adj. 不诚实的；不正直的
honest|adj. 诚实的；正直的；坦率的
foxy|adj. 妖艳的；性感的；狡猾的
crafty|adj. 巧妙的；狡诈的
haste|n. 急速；匆忙，仓促
hasten|v. 催促；赶紧；加速
hypocritical|adj. 伪善的；虚伪的
hypocrisy|n. 伪善；虚伪；造作
impatient|adj. 不耐烦的；焦急的
irresponsible|adj. 不负责任的；无责任感的
responsible|adj. 有责任的；负责任的
irritable|adj. 易怒的；易暴躁的
irritation|n. 愤怒；激怒；疼痛处
passive|adj. 消极的；被动的；被动语态的
inactive|adj. 不活动的；不活跃的；怠惰的
quarrelsome|adj. 爱争吵的；好争论的
rude|adj. 粗鲁的；无礼的
selfish|adj. 自私的
vulgar|adj. 庸俗的；粗俗的；粗野的；下流的
vulgarity|n. 粗俗；庸俗
weird|adj. 离奇的；古怪的；怪异的
hull|n. 外壳；皮；船身；船体；v. 去壳
hang|v. 悬挂；吊；绞死；n. 悬挂；绞刑
lift|v. 举起；抬起；提起；解除；n. 电梯；搭便车
frame|n. 框架；结构；骨架；模式；v. 制定；框住；陷害；表达
clear of sth.|phrase. 清除某物；远离某物
seabed|n. 海床
suction|n. 吸；抽吸；吸出；v. 抽吸；吸出
surrounding|adj. 周围的；附近的；v. 环绕；围绕；“surround”的现在分词
surround|v. 环绕；围绕
mud|n. 泥；泥土
salvage|v. 打捞；挽救；挽回；抢救；n. （对财物等的）抢救；抢救出的财物
progress|n. 进展；进步；缓慢前进；稳步前进；v. 进展；进步；（时间）逐渐过去；前进
progressive|adj. 先进的；前进的；n. 改革论者；进步论者
stage|n. 阶段；时期；舞台；v. 举行；上演
cape|n. 披风；海角
channel|n. 河床；海峡；（水）槽；渠道；频道；途径；v. 引导；开导；形成河道
coast|n. 海岸；海滨
coastal|adj. 海岸的；沿海岸的
gulf|n. 海湾；鸿沟；隔阂
inlet|n. 入口；进口；小湾
islet|n. 小岛
main stream|phrase. 干流；主流
maritime|adj. 海的；海事的；海运的
ocean current|phrase. 洋流
oceanic basin|phrase. 海盆
oceanic ridge|phrase. 海脊
oceanic trench|phrase. 海沟
offshore|adv. 离岸；近海岸；adj. 离岸的；近海的
saline|adj. 盐的；含盐的；咸的；n. 盐水
sea level|phrase. 海平面
sediment|n. 沉积物；沉淀物
sedimentation|n. 沉淀；冲积；沉积
sedimentary|adj. 沉积的；沉淀性的；沉淀作用造成的
shallow|adj. 浅的；浅薄的
strait|n. 海峡
submarine|n. 潜水艇；adj. 海面下的
ancient|adj. 古代的；古老的；n. 古人
antique|n. 古董；古代文物；adj. 古老的；过时的
antiquity|n. 古代；古迹；古老
archaeological|adj. 考古学的
archaeologist|n. 考古学家
archaeology|n. 考古学
archaic|adj. 古老的；过时的
artifact|n. 人工制品；手工艺品；加工品
burial object|phrase. 埋藏物；随葬品
chronological|adj. 按时间先后顺序排列的
data processing|phrase. 数据处理
excavate|v. 挖掘；发掘
excavation|n. 挖掘；发掘
medieval|adj. 中世纪的；中古的
Mesolithic|n. 中石器时代（旧石器时代与新石器时代之间的时代）；adj. 中石器时代的
Neolithic|adj. 新石器时代的
Paleolithic|adj. 旧石器时代的
prehistoric|adj. 史前的；陈旧的
prehistory|n. 史前时期
primordial|adj. 原始的；远古的；¸初的
remainder|n. 剩余物；其余的人；余数；v. 廉价出售
remains|n. 遗迹；残余；遗体；v. 剩下；留下；依然不变；“remain”的第三人称单数
remnant|n. 剩余；残余部分；零头布料；adj. 残留的
remote sensing|phrase. 遥感；远距离读出
residue|n. 残渣；剩余物
scientific method|n. 科学方法
skull|n. 颅骨；头骨
trace|n. 痕迹；轨迹；微量；追踪；v. 追踪；追溯；仔细查找；描摹
unearth|v. 掘出；挖掘；揭露
vestige|n. 丝毫；遗迹；痕迹
population|n. 人口
rapidly|adv. 迅速地；快速地
remain|v. 剩下；留下；保持
more or less|phrase. 或多或少
the arrival of ...|phrase. ...的到来
deadly|adj. 致死的；极度的；adv. 如死一般地；非常地
deathful|adj. 致命的
fatal|adj. 致命的；灾难性的
islander|n. 岛民；岛上居民
immunology|phrase. 免疫学
assassination|n. 暗杀；刺杀
choke|n. 窒息；阻塞；v. 窒息；阻塞
defunct|adj. 已故的；不复存在的；n. 死者
demise|n. 死亡；逝世；消亡；（不动产的）转让；让位
expire|v. 终止；期满；断气；死亡
expiry|n. 满期；终止
incinerate|v. 焚化；焚毁；把…烧成灰烬
invasive|adj. 侵入的；侵袭的；扩散的；开£的
lethal|adj. 致命的；可致死的
mischievous|adj. 调皮的；恶作剧的；有害的
mortal|n. 凡人；adj. 致命的；终有一死的
mortality|n. 死亡人数；死亡率；必死性
immortal|adj. 不朽的；永世的；不死的；n. 不朽的人物；神仙；永生不灭者
immortality|n. 不朽；永生
noxious|adj. 有害的；有毒的；可憎的
poisonous|adj. 有毒的
smother|v. 厚厚地覆盖；使…窒息；闷死
suicide|n. 自杀
suicidal|adj. 自杀的；有自杀倾向的；有致命危险的
toxic|adj. 有毒的；中毒的；n. 毒物；毒剂
toxicity|n. 毒性；毒力
non-toxic|adj. 无毒的
toxin|n. 毒素；毒质
poison|n. 毒药；毒物；v. 毒害；下毒
venom|n. 毒液；愤恨
venomous|adj. 分泌毒液的；有毒的；恶毒的
affirm|v. 断言；肯定；证实
affirmation|n. 肯定；确认；证实
reaffirm|v. 重申；再次肯定
assert|v. 断言；宣称；坚持；维护
assertiveness|n. 自信；果断；坚定
assertion|n. 断言；主张；声明
believe|v. 相信；认为；信任
conclude|v. 推断出；得出结论；结束
declare|v. 宣布；宣告；断言；申报纳税
deem|v. 认为；觉得
discerning|adj. 有辨别力的；能洞悉的；眼光敏锐的；v. 辨明；识别；洞悉；“discern”的现在分词
discernible|adj. 可辨别的
dogmatic|adj. 教条的；武断的；固执己见的
illegible|adj. 难辨认的；模糊的
pending|adj. 待定的；即将发生的；prep. 在等待…期间；直到…为止
protest|n. 抗议；抗议活动；v. 抗议
suppose|v. 认为；假设；猜想
crude|adj. 未加工的；粗鲁的；简陋的
awareness|n. 意识；认识；察觉
aware|adj. 意识到的；知道的
unaware|adj. 没意识到；不觉察的；不知道的
deal|n. 交易；协议；v. 处理；对付；交易
dealer|n. 经销商；商人
political|adj. 政治的；政权的
acid rain|phrase. 酸雨
air pollution|phrase. 空气污染
biodegradable|adj. 可生物降解的
carbon emission|n. 碳排放
carpool|v. 拼车
climatic deterioration|phrase. 气候恶化
deteriorate|v. 恶化；变坏；退化
disposable|adj. 用后即丢弃的；一次性的；可自由支配的
drive less|phrase. 少开车
ecological degradation|phrase. 生态退化
environmental awareness|phrase. 环保意识
environmental issue|phrase. 环境问题
environmental pollution|phrase. 环境污染
environmental protection|phrase. 环境保护
groundwater contamination|phrase. 地下水污染
hybrid electric vehicle|phrase. 混合动力电动汽车
industrial waste control|phrase. 工业废料管理
land resource|phrase. 土地资源
low carbon|phrase. 低碳
mass transportation|phrase. 大规模运输；公众交通
mineral resource|phrase. 矿产资源
noise pollution|phrase. 噪音污染
plastic bag|phrase. 塑料袋
pollutant|n. 污染物
polluter|n. 污染源；污染物质
pollution|n. 污染；污染物
radioactive|adj. 放射性的
rainfall|n. 降雨量；下雨
recycle|v. 再循环
refuse disposable goods|phrase. 拒绝使用一次性用品
renewable|adj. 可更新的；可再生的
reuse|n. 回用；重复使用；再次使用；v. 再使用；重复使用
sustainable development strategy|n. 可持续发展战略
water conservation|phrase. 节约用水；水分保持；水资源保护
water pollution|phrase. 水污染
water resource|phrase. 水资源
white pollution|phrase. 白色污染
worsen|v. 恶化；损害
automatically|adv. 自动地；无意识地
cognition|n. 认识；认知
subliminal|adj. 下意识的；潜意识的
subliminally|adv. 下意识地；潜意识地
perceive|v. 察觉；理解；发觉
exist|v. 存在；生存；活着
existence|n. 存在；生存
coexistence|n. 共存；共处
primitive|adj. 原始的；简陋的
traverse|v. 横穿；横越；穿过；n. 横贯；横木
game|n. 游戏；比赛
survival|n. 生存；存活；幸存；残存物
biophysical environment|phrase. 生物物理环境
cave man|phrase. 穴居人
common descent|phrase. 共同祖先
cranial|adj. 头盖的；颅骨的；颅的
Darwin|n. 达尔文（英国生物学家，进化论创立者）
Darwinism|n. （认为生物通过自然选择而进化的）达尔文主义；达尔文学说；进化论
degenerate|adj. 退步的；堕落的；腐化的；v. 退化；堕落；n. 堕落的人
degradation|n. 降级；恶化
descendant|n. 后裔；子孙；后代
descend|v. 下降；突然造访；突袭；沦落；起源
directional selection|phrase. 定向选择
ecological anthropologist|phrase. 人类生态学家
evolutionary change|phrase. 进化；渐进式改革
evolve|v. 形成；演变；进化
evolutionary|adj. 进化的；发展的；演变的
food chain|phrase. 食物链
hominid|n. 原始人类；adj. 人科的
natural selection|phrase. 自然选择；物竞天择
offspring|n. 后代；子女；幼苗
origin|n. 起源；起因；出身；来历
outgrow|v. 比…长得高（或大、快）；长大而不再；因长大而对…失去兴趣
paleoanthropologist|n. 古人类学家
paleoanthropology|n. 古人类学
psychological anthropologist|phrase. 人类心理学家
weed out|phrase. 清除；淘汰
consecutive|adj. 连续的；连贯的
successive|adj. 继承的；连续的
constantly|adv. 不断地；时常地
fitful|adj. 断断续续的；一阵阵的
frequency|n. 频率；频数；频繁
frequently|adv. 频繁地；时常
incessant|adj. 不断的；不停的；连续的
incoherent|adj. 不连贯的；语无伦次的
occasional|adj. 偶然的；临时的；不时的
occasionally|adv. 偶尔；有时
periodical|adj. 周期的；定期的；n. 期刊
periodically|adv. 周期性地；定期地
perpetual|adj. 永恒的；持续的；永久的
swift|adj. 快的；迅速的；敏捷的；n. 雨燕
introduce|v. 介绍；引进
introduction|n. 介绍；引言；传入
studious|adj. 好学的；用功的；仔细的；故意的
avoidance|n. 避免
avoid|v. 避免；避开
pattern|n. 模式；图案；样式；v. 形成图案；仿造
repeat|v. 重复；重做；n. 重复；重做
repeatedly|adv. 重复地；再三地
austerity|n. 紧缩；艰苦朴素；节俭
courtesy|n. 礼貌；谦恭
diligence|n. 勤奋；勤勉；用功
forgiveness|n. 宽恕；原谅；宽宏大量
gentilesse|n. （古语）礼貌；文雅
grace|n. 优雅；恩宠
honesty|n. 诚实；正直；老实
humility|n. 谦逊；谦虚；谦卑
kindness|n. 好意；善良
moral|adj. 道德的；道义上的；n. 寓意；道德
morality|n. 道德；道义
moralism|n. 伦理
norm|n. 准则；标准
superstructure|n. 上层结构；上部构造
upright|adv. 笔直地；adj. 直立的；竖直的；正直的；诚实的
valor|n. 英勇；勇猛
virtue|n. 美德；优点
willpower|n. 意志力；毅力
album|n. 相册；专辑
blues|n. 布鲁斯音乐；忧郁的情绪；n. 蓝色；“blue”的复数
cassette|n. 盒子；盒式磁带
composition|n. 构成；作品，作曲；（学生）作文；创作技巧
country-folk|n. 乡下人
country-pop|phrase. 乡村音乐
cowboy|n. 牛仔；牧童
disc|n. 圆盘；磁碟；唱片
funk|n. 恐惧；怯懦；放克音乐；v. 害怕；畏缩
hip-hop|n. 街舞；嘻哈文化；adj. 嘻哈的；嘻哈文化的
house|n. 房子；房屋
jazz|n. 爵士乐
melodic|adj. 有旋律的；调子美妙的
melody|n. 旋律；曲调
music|n. 音乐；乐曲
musical|adj. 音乐的；擅长音乐的；喜欢音乐的；悦耳的；n. 音乐剧；音乐歌舞片
notation|n. 记号；标记法；符号
punk|n. 小流氓；小阿飞；不良少年；废物；朋克摇滚乐；adj. 朋克风格的
rap|n. 说唱乐；v. 说唱；敲击
record|n. 记录；唱片；v. 记录；录制
reggae|n. 雷盖乐；雷鬼音乐
royalty|n. 皇家；皇族；版税
soul|n. 灵魂；心灵
stereo|n. 立体声；立体声音响；adj. 立体声的
tape|n. 磁带；胶带；录音带；带子；v. 录音；用带子捆；用胶带粘
tempo|n. 拍子；节奏；速度
timbre|n. 音色；音质；音品
tuneful|adj. 悦耳的
vocal|adj. 嗓音的；发声的；歌唱的；直言不讳的
duplication|n. 复制；重复；拷贝
copy|n. 复制品；副本；v. 复制；拷贝
replicate|v. 复制；重复
commence|v. 开始发生；着手
commencement|n. 开始；毕业典礼；学位授予典礼
inaugurate|v. 开创；为（某人）举行就职典礼；为…举行开幕仪式
inauguration|n. 就职典礼；开幕式；落成典礼
inaugural|adj. 就职的；开幕的；创立的；n. 就职演说
initial|adj. ¸初的；开始的；n. 首字母；v. 用姓名的首字母签名于
initially|adv. ¸初；开始；起初
preliminary|adj. 预备的；初步的
renew|v. 重新开始；更新
renewal|n. 更新；复兴；续订；恢复
resume|v. （中断后）继续；重新开始；n. 简历
threshold|n. 门槛；门口；起始点
doorway|n. 门口；门道；出入口
outset|n. 开端；起始
general|adj. 总的；普遍的；一般的；大致的；首席的；n. 将军
generalization|n. 概括；概论；归纳
sense|n. 知觉；感知；理解力；意义；v. 意识到；感觉到；觉察出
prescriptivism|n. 规定主义（指传统语法）
view|n. 视野；风景；见解；v. 审视；观看
variety|n. 变化；多样性；（同一事物）不同种类；（动植物的）品种
language|n. 语言
inherently|adv. 天性地；固有地；本质上地
ought to|phrase. 应该
impose|v. 强加；征收；施加影响；利用；强制实施
adaption|n. 适应；改编
advisable|adj. 明智的；可取的
becoming|adj. 合适的；与…相称的；适当的；v. 变成；成为；变得；“become”的现在分词
coincide|v. 一致；相符合；巧合
agree|v. 同意；赞成
conformity|n. 符合；一致；遵从；依照
fit|adj. 健康的；适合的；v. 符合；合身
fitting|n. 试衣；试样；adj. 适合的；恰当的；v. 符合；合身；“fit”的现在分词
pertinent|adj. 中肯的；相关的；切题的
plausible|adj. 看似真实的；似乎可信的；似乎合理的
properly|adv. 适当地；得体地；正确地
suitable|adj. 合适的；适宜的
abridge|v. 删节；缩短；精简
clause|n. 从句；条款
concise|adj. 简明的；简要的
genre|n. （文艺作品的）类型；体裁；题材
glossary|n. 术语汇编；词汇表
grammar|n. 语法
implicit|adj. 含蓄的；暗示的；无疑的；绝对的
lexical|adj. 词汇的
lingual|adj. 舌的；舌状的；语言的
parlance|n. 说法；用语；术语
phonemics|n. 音位学
sentence|n. 句子；判决；宣判；v. 判决；判刑
sound|n. 声音；声响；v. 响；听起来；adj. 健全的；完好的；合理的；可靠的；酣睡的
syllable|n. 音节
symbol|n. 符号；象征；标志
symbolic|adj. 象征的；符号的
tense|adj. 紧张的；拉紧的；n. 时态
decide|v. 决定
species|n. 物种；种类
indication|n. 指示；迹象；表示
rural|adj. 农村的；乡村的
urban|adj. 城市的；都市的
urbanization|n. 都市化；城市化
demonstration|n. 示范；演示；论证；示威
denote|v. 表示；代表
signify|v. 表示；预示；象征；要紧
disclose|v. 揭露；透露；泄露
expose|v. 暴露；揭露；使遭受
exposure|n. 暴露；显露；揭露
manifest|v. 表明；显现；使人注意到；adj. 明显的；n. 载货单；旅客名单
point|n. 点；观点；要点；分数；v. 指向；指出；弄尖；瞄准
presentation|n. 演出；展示；陈述；报告
proclaim|v. 宣告；公布；表明
announce|v. 宣布；宣称
proclamation|n. 宣言；公告；声明
revelation|n. 揭露；被揭示的真相
disclosure|n. 揭露；泄露；公开
concealment|n. 隐藏；藏匿；隐瞒
uncover|v. 揭开；揭露
unveil|v. 摘下面纱；揭幕；揭露
backward|adv. 向后地；adj. 向后的
cheap living expenses|phrase. 低生活成本；低生活花销
economic gap|phrase. 经济差距
hamlet|n. 小村庄
idyllic|adj. 田园诗的
imbalance|n. 失衡；不平衡
in the long run|phrase. 从长远来看；¸后
infrastructure|n. 基础设施
locality|n. 地区；地点
low crime rate|phrase. 低犯罪率
monotonous|adj. 单调乏味的；毫无变化的
on the brink of|phrase. 濒于；即将要
outskirts|n. 郊区
pastoral|adj. 牧师的；牧人的；田园的；n. 牧歌；田园诗；田园景色
quietness|n. 宁静；平静
suburb|n. 市郊；郊区
tedious|adj. 冗长的；沉闷的
tranquility|n. 宁静；安宁；平静
uninformed|adj. 知识不够的；不了解情况的；愚昧的
booming|adj. 急速发展的；暴涨的；繁荣发展的；v. 发出隆隆声；快速发展；暴涨；“boom”的现在分词
centralisation|n. 集中化
city centre|phrase. 市中心
city planner|phrase. 城市规划师
commercialisation|n. 商业化
metropolis|n. 大都市；首府
municipal|adj. 市的；市政的
municipality|n. 自治市；市当局
real estate|phrase. 房地产；不动产
residential area|phrase. 住宅区；居民区
residential quarter|phrase. 住宅区
shopping centre|phrase. 购物中心；商业中心
slum|n. 贫民窟；贫民区
traffic congestion|phrase. 交通堵塞；交通拥挤
urban construction|phrase. 城市建设
urban sprawl|phrase. 城市无规划扩张
result|n. 结果；成败；成效；比分；v. 由于；导致
announcement|n. 通告；宣告
announcer|n. 广播员；告知者；报幕员
reveal|v. 揭露；泄露；（使）显露；n. （电视节目¸后的）揭示
disease|n. 病；疾病
associate|v. 把…联系在一起；与…交往；n. 同事；伙伴；adj. 副的
afflict|v. 使痛苦；使苦恼；折磨
torment|n. 痛苦；折磨；令人痛苦的东西；v. 折磨；使痛苦；烦扰；纠缠；戏弄
torture|n. 酷刑；拷打；v. 拷打；折磨
adequate for|phrase. 适合； 足够
assessment|n. 评估；评定；估计
bear through|phrase. 忍耐
concentrate on|phrase. 集中于； 专心于
describe as|phrase. 描述为
effort|n. 努力；尽力
environmental aspect|phrase. 环境概貌（状况、条件）；环境因素
feedback|n. 反馈
financial strain|phrase. 资金紧张
fulfill duty|phrase. 履行职责
go to great lengths to|phrase. 不遗余力地
goal-oriented|phrase. 目标导向型；目标导向的
goal-setting|phrase. 目标设定
high-efficiency|phrase. 高效；高效的
in-depth interview|phrase. 深度访谈
merit|n. 优点；功绩；价值；v. 值得；应得
profitability analysis|phrase. 获利能力分析；盈利分析
questionnaire|n. 调查问卷；调查表
risk analysis|phrase. 风险分析
sampling survey|phrase. 抽样调查
statistic analysis|phrase. 统计分析
SWOT analysis|phrase. 强弱危机分析；四点分析(SWOT = Strength, Weakness, Opportunity, Threats)
target|n. 目标；对象；靶；v. 以…为目标；瞄准
task-oriented|phrase. 任务导向的；工作取向的
under investigation|phrase. 在调查中
ache|n. 疼痛；隐痛；渴望；v. 疼痛；隐痛
Alzheimer's|n. 阿尔茨海默氏症；老年性痴呆
Alzheimer's disease|phrase. 阿尔兹海默症
amnesia|n. 健忘症；记忆缺失
atrophy|n. 萎缩；衰退；v. 萎缩；衰退
backache|n. 背痛；腰痛
central paralysis|phrase. 中枢性瘫痪
dehydrate|v. （使）脱水；去水
dementia|n. 痴呆；失智症
diagnosable|adj. 可诊断的
disturbance|n. 干扰；障碍；紊乱；骚乱
dreaminess|n. 多梦
dry eyes|phrase. 不落泪的眼(指不哭的人)；干涩的眼睛；干眼症
emotional instability|phrase. 情绪不稳
endocrine|adj. 内分泌腺的；内分泌的
enfeeble|v. 使衰弱；使无力
epilepsy|n. 癫痫；羊角风
fatigue|n. 疲乏；劳累
get numb|phrase. 麻木
hemiplegia|n. 偏瘫；半身麻痹
insomnia|n. 失眠（症）
language barrier|n. 语言障碍
lose consciousness|phrase. 失去知觉；昏厥
memory deterioration|phrase. 记忆力衰退
migraine|n. 偏头疼
nerve system|phrase. 神经系统
nervousness|n. 紧张不安；局促；神经质
neuralgia|n. 神经痛
neurological|adj. 神经学的；神经病学的
paralysis|n. 瘫痪；麻痹
paralytic|adj. 瘫痪的；麻痹的；烂醉的；n. 瘫痪病人；麻痹患者
paralyse|v. 使麻痹；使瘫痪；使无效；使停止活动
Parkinson's disease|phrase. 帕金森病
sleep disorder|phrase. 睡眠障碍；失眠
tinnitus|n. 耳鸣
episodic|adj. 由松散片段组成的；插曲般的；不定期发生的
process|n. 过程；进程；工序；v. 处理；加工
course|n. 课程；过程；一道菜；v. 快速流动；（思想或感情）涌动
encode|v. 给…加密；将…译成密码；编码
information|n. 信息；资料
strengthen|v. 加强；巩固
stabilise|v. 使稳定；使安定
stabilisation|n. 稳定
stability|n. 固定；牢固；稳定
facilitate|v. 使容易；使便利；促进；帮助
retrieval|n. 取回；挽回；重获；检索
retrieve|v. 取回；重新获得；检索数据
arouse|v. 引起（兴趣/愤怒等）
elicit|v. 引出；诱出；探出
elicitation|n. 启发
foment|v. 煽动；激起
fortify|v. 设防御工事；加强；增加营养物
impel|v. 促使；驱策；迫使
compel|v. 强迫；胁迫
dispel|v. 驱散；消除；打消
impetus|n. 冲力；推动力；刺激
incite|v. 煽动；刺激；鼓动
instigate|v. 教唆；煽动；激起
intensify|v. 加强；强化
rise|v. 上升；提高；n. 上升；提高
kindle|v. 点燃；生火；激起；发亮
promote|v. 促进；推动；提拔；宣传；推销
promotion|n. 促进；提升；推广
prompt|adj. 迅速的；准时的；v. 提示；促使；n. 提示；提词
promptly|adv. 马上；迅速地；敏捷地；准时地
propel|v. 推进；推动
stimulate|v. 刺激；激励
urge|v. 催促；力劝；n. 强烈欲望；迫切要求
balance|n. 天平、秤；平衡；收支差额；余额；v. （使）平衡；（使）相抵
erratic|adj. 古怪的；飘忽不定的；不稳定的
immobile|adj. 不能移动的；静止的
mobile|adj. 可移动的；易变的
immobility|n. 固定性；不动；不变
immutable|adj. 不可改变的；永恒不变的
active|adj. 积极的；活跃的；主动的
poise|n. 平衡；姿态；镇静；v. 使平衡；保持（某种姿势）
stable|adj. 稳定的；牢固的；稳重的；n. 马厩；畜舍
unstable|adj. 不稳定的
static|adj. 静止的；不变的；n. 静电
dynamic|adj. 动态的；有活力的；不断变化的；n. 活力；动力
stationary|adj. 固定的；不动的
steady|adj. 稳定的
steadily|adv. 稳定地；稳固地
variable|adj. 可变的；易变的；不稳定的；n. 变量；易变的东西
variability|n. 可变性；易变性
dispose|v. 安排；处置；处理；除去；有…倾向；有意于
handle|v. 处理；操纵；n. 柄；把手
tackle|v. 处理；阻截；n. 用具；阻截
treat|v. 对待；招待；治疗；n. 款待
in the course of|phrase. 在...期间
conduct|v. 实施；表现；指挥；引导；传导（电、热）；n. 行为，举止；实施方式
a number of|phrase. 许多的；大量的
discover|v. 发现；查明；发觉
discovery|n. 发现；发觉
fail to|phrase. 未能...
obvious|adj. 明显的；显然的
profound|adj. 深刻的；渊博的；深奥的；深远的
abstruse|adj. 难解的；深奥的
esoteric|adj. 秘传的；深奥的；难懂的
trend|n. 趋势；走向；v. 倾向
effect|n. 影响；作用；效果；效应；v. 引起；实现；使生效
consumer|n. 消费者
consumerism|n. 消费主义；保护消费者权益主义
aspiration|n. 渴望；抱负；志向；吸气；送气音
attitude|n. 态度；看法；姿态
behaviour|n. 行为；举止；表现
manner|n. 方式；举止；礼节
abundant|adj. 丰富的；充裕的
abundance|n. 丰富；充足
ample|adj. 足够的；丰裕的
copious|adj. 大量的；丰富的
excess|n. 过度；超过；过量；adj. 多余的；过多的
lavish|adj. 奢侈的；慷慨给予的；挥霍的；过多的；v. 浪费；挥霍；慷慨给予
extravagant|adj. 奢侈的；过度的
mass|n. 大量；质量；团；块；群；adj. 大量的；大规模的
miscellaneous|adj. 混杂的；各种各样的
multitude|n. 大量；众多；群众
numerous|adj. 许多的；众多的
plenteous|adj. 许多的；丰饶的；充足的；丰富的
plentiful|adj. 丰富的；充裕的
plethora|n. 过多；过量；过剩
profuse|adj. 大量的；不吝惜的；浪费的
profusion|n. 大量；丰富；慷慨；浪费
prolific|adj. 多产的；作品丰富的
substantially|adv. 实质上；大体上；充分地
substance|n. 物质；物品；实质；主旨；要点
sufficient|adj. 足够的；充足的
insufficient|adj. 不充分的；不足的
swarm|n. 群；蜂群；v. 云集；充满
wealth|n. 财富；财产
bundling|v. 捆绑；“bundle”的现在分词
bundle|n. 捆；束；包
client|n. 客户；委托人；当事人
gender|n. 性别；（语法）性
low-income|adj. 低收入的
passivity|n. 被动；不抵抗；消极状态
propensity|n. （性格上的）倾向；习性
purchasing power|phrase. 购买力
target audience|phrase. 目标听众
targeted|v. 把 ... 作为目标；瞄准；“target”的过去式和过去分词
temptation|n. 诱惑
upscale|adj. 高消费的；高档的
conviction|n. 坚信；判罪；信服
historical|adj. 有关历史的
relic|n. 遗迹；遗物；遗风；纪念物
infallible|adj. 一贯正确的；万无一失的
testimony|n. 证明；证据；证词
objective|n. 目标；目的；adj. 客观的
goal|n. 目标；进球得分；球门
aim|n. 目标；目的；v. 瞄准；以其为目标
value|n. 价值；（数）值；v. 估价；重视
bequest|n. 遗产；遗赠
heritage|n. 遗产；继承物；传统
inheritance|n. 遗产；遗产继承；继承物
legacy|n. 遗产；遗赠
begrudge|v. 嫉妒；羡慕；不乐意地做（或付出）
desperate|adj. 绝望的；不顾一切的；拼死的；极度渴望的
flatter|v. 奉承；讨好；向…谄媚；adj. 更平坦的；更扁平的；“flat”的比较级；adv. 更平直地；更直截了当地；“flat”的比较级
flatterer|n. 奉承者；马屁精
flattery|n. 奉承；阿谀；恭维话
hesitate|v. 犹豫；踌躇
hesitation|n. 犹豫；踌躇
indecision|n. 优柔寡断；犹豫不决
indifferent|adj. 不感兴趣的，不关心的；（水平）一般的
jealous|adj. 妒忌的；嫉妒的
scruple|n. 顾虑；顾忌；踌躇；v. 顾虑；有顾忌
vacillate|v. 游移不定；踌躇；犹豫
ascertain|v. 查明；弄清；确定
clarify|v. 澄清；阐明
confident|adj. 自信的；确信的
doctrine|n. 学说；教义；教条
exact|adj. 精确的；准确的；v. 强求；急需；要求
exactly|adv. 确切地；准确地；正是
institute|n. 协会；学院；研究所；机构；v. 建立；制定；开创；开始
tentative|adj. 不确定的；暂定的；试验性的；踌躇的
theoretically|adv. 理论上；理论地
switch|v. 转换；n. 开关
swap|v. 交换；n. 交换
autoganzfeld|adj. 自动超感官知觉全域的
automate|v. 使自动化
automation|n. 自动化
variant|adj. 相异的；各种各样的；不定的；n. 变体；变种；变形
technique|n. 技术；工艺；技巧；技艺
performance|n. 表演；表现；性能；履行；执行
random|adj. 随意的；任意的；n. 随意； 任意
irregular|adj. 不规则的；无规律的；不合法的
designed|adj. 精心设计的；v. 设计；“design”的过去式和过去分词
arranged|adj. 安排的；v. 安排；“arrange”的过去式和过去分词
selection|n. 挑选；选择
choice|n. 选择；抉择；精选品；adj. 上等的；精选的
bluetooth|n. 蓝牙
card reader|phrase. 读卡机
CD|abbr. 激光唱片；光盘；“Compact Disc”的缩写
compact disc|phrase. 激光唱片；光盘
CD-ROM|abbr. 光盘只读存储器；光盘驱动器；“compact disc read-only memory”的缩写
compact disc read-only memory|phrase. 只读光盘
copycat|n. 模仿者；adj. 模仿犯罪的
cord|n. 细绳；绳索
CPU|abbr. 中央处理器；“Central Processing Unit”的缩写
central processing unit|phrase. （CPU）中央处理机
expandable|adj. 可膨胀的；可张开的
film|n. 电影；底片；薄薄的一层；v. 拍摄电影
headset|n. 戴在头上的耳机或听筒
USB hub|phrase. 集线器
ink box|phrase. 墨盒
keyboard|n. 键盘
lens|n. 透镜；镜片
memory card|phrase. 记忆卡
memory-chip|n. 存储芯片；内存芯片
microphone|n. 麦克风；扩音器
modem|n. 调制解调器
monitor|n. 监视器；班长；显示器；v. 监控；监视
motherboard|n. 主板
mouse|n. 老鼠；鼠标
plug in|phrase. 插上插头
power adapter|phrase. 电源适配器
power supply|phrase. 电源
router|n. 路由器
slot|n. 狭槽；投币口；v. 把…放入狭缝
solid state disk|phrase. 固态盘
trial version|phrase. 试用版
USB cable|phrase. 传输线
webcam|n. 网络摄像机
accomplish|v. 完成；实现
assign|v. 分配；指派
assignment|n. 分配；指派；任务；作业
mission|n. 使命；任务；使团
responsibility|n. 责任；职责
available|adj. 可获得的；可用的；有空的
station|n. 车站；站
journey|n. 旅行；旅程
voyage|n. 航行；航海；v. 航行；远航
require|v. 需要；要求
need|n. 需要；v. 需要
requirement|n. 需求；要求；必要条件
full fare|phrase. 全票价
valid|adj. 有效的；有根据的；正当的
inspection|n. 检查；视察；查看；审视
scrutiny|n. 细阅；详细检查；仔细研究
airliner|n. 班机；大型客机
airplane|n. 飞机
automobile|n. 汽车
bunk|n. 铺位；卧铺；v. 提供铺位；睡在铺上
by tube|phrase. 乘地铁
carriage|n. 四轮马车；运输；举止；仪态
compartment|n. 分隔间；车厢
cruise ship|phrase. 大型游轮
destination|n. 目的地；终点
electric tram|phrase. 有轨电车
escalator|n. 自动扶梯；电动扶梯
ferryboat|n. 渡船；渡轮
light rail|phrase. 轻轨
platform|n. 平台；站台；月台
subway station|phrase. 地铁车站
terminus|n. 终点站
ocean-going vessel|phrase. 远洋船
yacht|n. 游艇；快艇；帆船；v. 驾游艇；乘游艇
amenity|n. 舒适；怡人；便利设施
apparatus|n. 装置；仪器；器械；器官
appliance|n. 家用电器；器具
axis|n. 轴；轴线
device|n. 设备；装置；手段；策略；方法
fixture|n. 固定物；固定装置；固定成员
gadget|n. 小配件；小器具
gear|n. 用具；齿轮；排挡；v. 换挡；调整；（使）适合
instrumental|adj. 仪器的；乐器的；有帮助的
maneuver|n. 精巧动作；军事演习；花招；v. （熟练地）移动；操控；算计
outfit|n. 全套装备；整套服装；配备；机构；v. 装备；配置设备；供给服装
pivot|n. 枢；中心；旋转；v. 在枢轴上转动；以…为中心
practical|adj. 实际的；实践的；实用的
rig|n. 索具装备；钻探设备；装备；v. 配备索具；操纵；舞弊
sanitation|n. 公共卫生；卫生设施
industrial|adj. 工业的；产业的
output|n. 产量；产物；输出
productivity|n. 生产力；生产率
soar|v. 翱翔；骤升
withdraw|v. 撤回；撤退；提取
aquifer|n. 地下蓄水层；砂石含水层
distilled water|phrase. 蒸馏水
drain|v. 排水；流掉；弄干；饮尽；消耗；n. 排水；下水道
drainage|n. 排水；排水系统；放水
drinking water|phrase. 饮用水
fresh water|phrase. 淡水
groundwater|n. 地下水
hard water|phrase. 硬水
running water|phrase. 流水；活水
salt water|phrase. 盐水
sea water|phrase. 海水
sewage|n. 污水；污物；下水道
surface water|phrase. 地表水
tap water|phrase. 自来水；非蒸馏水
waste water|phrase. 废水
boost|v. 使增长；提高；促进；n. 提高；增加；帮助
burgeon|v. 迅速生长；急速增长
enhance|v. 提高；增强
enhancement|n. 增强；改善；增加；增进
enhanced|adj. 增强的；提高的；v. 提高；增强；“enhance”的过去式和过去分词
hoist|v. 提升；吊起；举高；n. 吊升机械；起重机
raise|v. 提起；增加；养育；筹募；引起；n. 加薪
skyrocket|n. 冲天火箭；v. 剧增；猛涨；猛升
spiral|n. 螺旋形；陡升或骤降；v. 螺旋式上升（或下降）；adj. 螺旋形的
abate|v. 减轻；减少；消除
depress|v. 压下；降低；使沮丧；使不活泼；使萧条
fall|v. 下降；跌倒；n. 落下；跌落；秋天
reduction|n. 减少；缩小
slip|v. 滑倒；滑落；溜走；悄悄地放；n. 滑倒；溜走；疏忽；纸片
age structure|phrase. 年龄结构
birth rate|phrase. 人口出生率
census|n. 人口普查
family planning|n. 计划生育
mobile population|phrase. 流动人口
natural growth|phrase. 人口自然增长；自然发展
populate|v. 居住于；生活于；移民于
populous|adj. 人口众多的；人口密集的
rural population|phrase. 农村人口
sex ratio|phrase. 性别比例
uneven|adj. 不平坦的；不均¤的；参差不齐的
urban population|phrase. 城市人口
assembly line|phrase. 生产线；装配线
automated production|phrase. 自动化生产
automatic|adj. 自动的
current production|phrase. 流水生产
industrialisation process|phrase. 工业化进程
maintenance|n. 维持；维修；保养
manual|n. 说明书；指南；adj. 手工的；体力的
workshop|n. 车间；工场；研讨会
achiever|n. 成功者；获得成功的人
self-regulatory|adj. 自我管理的
regulate|v. 管制；调整
strategy|n. 策略；战略
transfer|v. 转移；转让；调任；n. 转移；转让；调任
transference|n. 移动；转送；转让；调动
transferable|adj. 可转移的；可转让的
unfamiliar|adj. 不熟悉的；陌生的
application|n. 应用；申请
deploy|v. 部署；有效地利用
employ|v. 雇佣；使用
employable|adj. 具备受雇条件的
revival|n. 复兴；复苏；再生
utilize|v. 利用
utilization|n. 利用；效用
academic|adj. 学院的；学术的；n. 大学教师；学者
academia|n. 学术界；学术环境
academically|adv. 学术上；学术地；理论上
discipline|n. 纪律；训练；惩戒；学科；科目；v. 训练；约束自己；惩罚
dissertation|n. 专题论文；学位论文
essay|n. 散文；文章；尝试；企图；v. 企图；尝试
literate|adj. 识字的；有读写能力的；有文化的；n. 识字的人；有学问的人
margin|n. 边缘；差额；利润；页边的空白处；余地
pamphlet|n. 小册子
thesis|n. 论点；论文
transcript|n. 副本；抄本；成绩单
conversion|n. 转换；转化；改变信仰
diversion|n. 转移；改道；分散注意力；消遣
shift|v. 变换位置；转移；换（挡）；轮班；n. 转移；移位；转变；轮班
shifting|adj. 不断移动的；v. 转移；轮班；“shift”的现在分词
transform|v. 转变；改造
transformer|n. 变压器
transition|n. 转变；过渡；变迁
change|n. 变化；变革；零钱；v. 变化；变革
transitional|adj. 变迁的；过渡期的
awesome|adj. 令人敬畏的；令人畏惧的；棒极了
cool|adj. 凉的；凉爽的；冷静的；顶好的；酷的；v. 变凉；冷静下来
excellence|n. 卓越；优秀；杰出
excellent|adj. 优秀的；杰出的；卓越的
fantastic|adj. 奇异的；极好的；奇妙的
first-class|adj. 优异的；一流的；头等的
super|adj. 超级的；极好的
terrific|adj. 极好的；大得惊人的
wonderful|adj. 精彩的；极好的
indicate|v. 指示；表明
indicator|n. 指示器；指标；指针；迹象
bilingual|adj. 两种语言的；用两种语言的
cognitive|adj. 认知的；认识的
mechanism|n. 机制；机械装置
recruit|v. 征募；招收；招聘；n. 新兵；新成员
recruitment|n. 征募；补充；招聘
recruiter|n. 征兵人员；招聘人员
alternate|adj. 交替的；轮流的；间隔的；v. （使）交替；（使）轮流；n. 代替者；候补者
compensate|v. 补偿；弥补
pay|v. 支付；付出代价；n. 工资
damage|v. 损害；破坏；n. 损害；破损
diction|n. 措辞；发音
lexicology|n. 词汇学
morphology|n. 形态学；词法
morphological|adj. 形态学的
phonology|n. 音系学；语音体系
semantics|n. 语义学；符号学
syntax|n. 句法；句子结构学；语构；语法
consistency|n. 始终一贯；前后一致；稠度；浓度
consistent|adj. 一致的；始终如一的
dominance|n. 优势；控制；支配
fluent|adj. 流畅的；流利的
identity|n. 身份；特性；一致
immersion|n. 浸没；沉浸；专心
interpreter|n. 作口译的人
proficient|adj. 熟练的；精通的；n. 专家；能手；老手
acumen|n. 敏锐；聪明
canny|adj. 精明的；老谋深算的
dexterous|adj. 灵巧的（手）；熟练的；敏捷的
keen|adj. 热心的；敏锐的；渴望的
penetrating|adj. 敏锐的；尖锐的；穿透的；有洞察力的；v. 渗透；看穿；洞察；“penetrate”的现在分词
perspicacious|adj. 颖悟的；敏锐的；有洞察力的
sharpen|v. 使尖锐；使急剧；使提高
shrewd|adj. 精明的；敏锐的；机灵的
smart|adj. 聪明的；敏捷的；时髦的；衣冠楚楚的；v. 剧痛；刺痛；感到难过
brain stem|phrase. 脑干
central nervous system|phrase. 中枢神经系统
centralis|n. 中央；中枢
gray matter|phrase. 灰质
nerve|n. 神经；勇气；胆量
neuron|n. 神经元；神经细胞
peripheral|adj. 外围的；周边的；次要的；n. 外围设备
periphery|n. 外围；周边；次要部分
spinal cord|phrase. 脊髓
spinal nerve|phrase. 脊神经
tract|n. 大片土地；短文；小册子；（体内）管道
traction|n. 牵引；牵引力；拉力；拖拉；附着摩擦力
tractor|n. 拖拉机；牵引机
white matter|phrase. 白质
monopoly|n. 垄断
cinnamon|n. 肉桂；肉桂色
impossible|adj. 不可能的
spice|n. 香料；调味品；趣味
trade|n. 贸易；交易；行业；v. 贸易；交易
diminish|v. 减少；削弱；减损；贬低
possible|adj. 可能的；也许会（发生）的
potentiality|n. 潜力；潜在性
supersede|v. 取代；代替；替代
entrepreneur|n. 企业家；创业者；承包人
exporter|n. 出口商
export|v. 输出；出口；n. 输出；出口
importer|n. 进口商；输入者
import|v. 进口；输入；n. 进口；输入；重要性；含义
transnational|adj. 跨国的；多国的
allocation|n. 分配；配给；拨款
allocate|v. 分配；配给
commercialise|v. 使商业化
consume|v. 消耗；消费；毁掉；（使）沉溺；（使）沉迷；（使）充满
cooperation|n. 合作；协作
equilibrium|n. 平衡；均衡；平静
establish|v. 建立；确立；制订；使被安排好；使认定；使承认
establishment|n. 建立；机构
externality|n.  外在性；外形；外部事物；（经济学名词）外部效应
fluctuate|v. 波动；起伏不定
waver|v. 摇摆；动摇；犹豫；n. 动摇；犹豫
vary|v. 改变；变化；使多样化
inflation|n. 膨胀；充气；通货膨胀
investment|n. 投资
invest|v. 投资；投入
loyalty|n. 忠诚；忠实
lucrative|adj. 赚大钱的；获利多的
macroeconomics|n. 宏观经济学
microeconomics|n. 微观经济学
mutual benefit|phrase. 互惠；互利
negotiation|n. 谈判；协商；磋商
predictability|n. 可预见性
transaction|n. 交易；业务
exchange|n. 交换；交易所；兑换；v. 交换；兑换
capital|n. 首都；资本；省会
fund|n. 基金；资金；v. 提供资金
depreciation|n. 折旧；贬值；跌价
fiscal|adj. 财政的；国库的
hyperinflation|n. 恶性通货膨胀
tariff|n. 关税；税率；（旅馆、饭店等的）价目表
taxation|n. 征税；税款
tax|n. 税；税款；v. 对...征税；使负重荷
trade price|phrase. 批发价；交易价格
commodity|n. 商品；货物；日用品
goods|n. 商品；货物
inventory|n. 详细目录；清单；储备；存货
merchandise|n. 商品；货物；v. 推销；销售
production|n. 生产；制造；产量
trademark|n. 商标；标记
feature|n. 特征；报刊特写；v. 以…为特色；是…的重要组成；放映
attract|v. 吸引
lure|v. 吸引；诱惑；引诱；n. 诱惑；诱饵；吸引力
attractive|adj. 有吸引力的
attraction|n. 吸引；吸引力
attractant|n. 诱引剂；吸引剂
attention|n. 注意；关注；照料
interactive|adj. 相互作用的；交互的
blockbuster|n. 轰动；巨型炸弹
stunning|adj. 极好的；足以使人晕倒的；令人震惊的；v. 使眩晕；使震惊；使目瞪口呆；“stun”的现在分词
stun|v. 使昏迷；使震惊
scenery|n. 风景；景色
backdrop|n. 背景幕布；背景
copyright|n. 版权；著作权
correspondent|n. 通讯记者；通信者
edition|n. 版次；版本
editorial|adj. 编辑的；社论的；n. 社论
montage|n. 蒙太奇；画面剪辑；合成画；大杂烩
post-synchronization|n. 后期录音合成；后期配音
premiere|n. 首映；首演；v. （使）首映；（使）首演
romance|n. 浪漫史；恋情；爱情小说；传奇色彩
subtitle|n. 副标题；说明或对白的字幕；v. 给 ... 加副标题；给 ... 加字幕
title|n. 标题；称号；头衔
trailer|n. 拖车；挂车；预告片
canyon|n. 峡谷
creek|n. 小河；溪流
crystal|n. 水晶；结晶；adj. 晶体的
estuary|n. 港湾；河口湾；河口；入海口
gorge|n. 峡谷；山谷；v. 贪婪地吃；狼吞虎咽
landscape|n. 景色；风景画
lawn|n. 草坪；草地
limpid|adj. 清澈的；透明的；清晰的
meadow|n. 草地；牧场
panorama|n. 全景；概论
picturesque|adj. 如画的；（语言）生动的
plain|n. 平原；adj. 简单明了的；朴素的
plateau|n. 高原；平稳期
highland|n. 高地；高原
tableland|n. 高原；台地
puddle|n. 水坑；洼；胶泥
scenic|adj. 舞台布景的；戏剧的；风景优美的
shade|n. 荫；遮蔽处；阴影；v. 遮蔽；画阴影
spectacle|n. 景象；奇观；场面；眼镜
spring|n. 春天；弹簧；泉；v. 跳；跃；蹦；突然猛烈地移动
summit|n. 顶峰；顶点；顶尖；¸高级会谈；首脑会议；adj. ¸高级的；政府首脑的
peak|n. 高峰；顶峰；帽檐；v. 达到高峰；达到¸高值；adj. ¸高的；高峰期的
trickle|v. 滴流；慢慢移动；n. 细流；徐徐地流
tundra|n. 苔原；冻原
glorious|adj. 光荣的；辉煌的
gorgeous|adj. 华丽的；绚丽的；极好的
grand|adj. 壮丽的；堂皇的；痛快的；重大的；总的；n. 一千美元（或英镑）；大钢琴
magnificent|adj. 壮丽的；宏伟的；华丽的
magnificently|adv. 壮观地
magnificence|n. 富丽堂皇；壮丽
radiant|adj. 发光的；辐射的；容光焕发的
solemn|adj. 严肃的；庄严的；隆重的
spectacular|adj. 壮观的
splendid|adj. 壮观的；辉煌的；极好的
elaborate|v. 精心制作；详尽阐述；adj. 精心制作的；详尽的
elegant|adj. 优雅的；优美的；典雅的
elegance|n. 高雅；典雅；优雅
inelegant|adj. 不雅的；粗俗的
exquisite|adj. 精美的；细腻的；强烈的
graceful|adj. 优雅的；优美的；得体的
polished|adj. 抛光的；磨光的；擦亮的；优雅的；精练的；v. 擦亮；磨光；润色；“polish”的过去式和过去分词
polish|v. 擦亮；磨光；润色；完善；n. 光泽；上光剂
refined|adj. 精炼的；优雅的；经过改良的；v. 精炼；改进；“refine”的过去式和过去分词
researcher|n. 研究员
aging|n. 变老；老化；adj. 变老的；老化的；v. 变老；“age”的现在分词
note|n. 笔记；便条；注释；音调；语气；钞票；v. 注意；备注；记录
treatment|n. 治疗；处理；待遇
on the market|phrase. 上市；出售
prove|v. 证明；证实
build-up|n. 逐步的增长；造舆论
molecular|adj. 分子的；分子构成的
cellular|adj. 细胞的；多孔洞的；蜂窝状的
infirmity|n. （长期的）体弱
cell biologist|phrase. 细胞生理学家
cell division|phrase. 细胞分裂
cell|n. 细胞；小房间；牢房；单元格
marrow cell|phrase. 骨髓细胞
molecular engineering|phrase. 分子工程学；分子工程
organic molecule|phrase. 有机分子
organism|n. 生物体；有机体；有机组织
stem cell|phrase. 干细胞
demolish|v. 毁坏；拆除；推翻
demolition|n. 摧毁；拆毁；拆除；大败
destruction|n. 毁灭；引起毁灭的根源
destructive|adj. 破坏的；毁灭性的
devastate|v. 毁灭；摧毁；变成废墟
disruption|n. 中断；扰乱；混乱
disrupt|v. 使混乱；使中断；扰乱
impair|v. 损害；削弱
improve|v. 改善；改进；提高
injure|v. 损害；伤害
injury|n. 损伤；伤害
spoil|v. 宠坏；搞糟；变质；n. 赃物；战利品
undermine|v. 逐渐削弱；暗中损害
accompany|v. 陪伴；伴随；为…伴奏
aging of population|phrase. [医] 人口变老
decrepit|adj. 衰老的；老朽的；破旧的
elderly|adj. 年老的；年长的
later|adv. 后来；稍后；adj. 后来的；稍后的；晚些的；晚年的
life|n. 生活；生命；人生
lifetime|n. 寿命；一生；终身
moribund|adj. 即将结束的；濒临死亡的；垂死的；n. 将死的人
regressive|adj. 退化的；倒退的；回归的
senior citizen|phrase. 老年人
support|v. 支持；支撑；n. 拥护；帮助
take care of|phrase. 照顾；照料；处理；应付
wrinkle|n. 皱纹；v. 起皱纹；弄皱…
tend|v. 趋向；朝向；往往会；照料；看护
humanity|n. 人性；人类；人道；仁慈
humankind|n. （统称）人类
mercy|n. 仁慈；怜悯
glacial|adj. 冰河的；冰冷的；冷淡的
anticyclone|n. 反气旋
density|n. 浓密；密度
direct sunlight|phrase. 直射阳光
element|n. 元素；要素；成分
elemental|adj. 元素的；自然力的；基本的
evaporated|adj. 蒸发的；脱水的；v. 使蒸发；使脱水；“evaporate”的过去式
hectopascal|n. 百帕斯卡（大气压测量单位）
moist|adj. 潮湿的；湿润的
moisture|n. 湿气；潮湿
mysterious|adj. 神秘的
seasonal demand|phrase. 季节性需求
subtropical|adj. 亚热带的
sunrise|n. 日出；黎明
sunset|n. 夕阳；落日
tropical cyclone|phrase. 热带气旋
uncontaminated|adj. 未污染的
balmy|adj. 温和宜人的（气候）；芳香的
breeze|n. 微风；和风
brisk|adj. 轻快的；爽快而清新的；兴隆的；v. 使…活泼；使…轻快
centigrade|n. 摄氏度
chilly|adj. 寒冷的；冷淡的；冷漠的
chill|n. 寒冷；寒意；v. 变冷；使冰冷；adj. 寒冷的
damp|adj. 潮湿的；n. 潮湿；v. 使潮湿
dank|adj. 阴湿的
dew|n. 露；露水
dewdrop|n. 露珠；水珠
downfall|n. 没落；垮台；骤雨
downpour|n. 倾盆大雨；暴雨
drizzle|v. 下毛毛雨；（毛毛雨似的）洒落；n. 毛毛细雨
fahrenheit|n. 华氏温度
foggy|adj. 有雾的；模糊的
freezing|adj. 极冷的；冰冻的；v. 结冰；冻结；“freeze”的现在分词
freeze|v. （使）结冰；（使）冻结；n. 严寒期；冻结
frigid|adj. 寒冷的；冷淡的；性冷淡的（女子）
frigidity|n. 寒冷；冷淡；（女子）性冷淡
frost|n. 霜；霜冻；严寒；v. 结霜
frosty|adj. 霜冻的；严寒的；冷淡的
hail|n. 冰雹；v. 下冰雹；呼喊；欢呼；把…誉为
haze|n. 薄雾；霾；迷蒙；迷糊；v. 笼罩在薄雾中；变模糊
hazy|adj. 朦胧的；模糊的；不清楚的
humid|adj. 潮湿的；湿润的
light air|phrase. 轻风；一级风
mist|n. 薄雾；朦胧不清
misty|adj. 有薄雾的；模糊的
moderate rain|phrase. 中雨
nippy|adj. 寒冷的；刺骨的
overcast|adj. 多云的；阴暗的；忧愁的
rain cats and dogs|phrase. 下倾盆大雨
serene|adj. 平静的；宁静的；安详的
shower|n. 淋浴；阵雨；一阵
sleet|n. 雨夹雪；v. 下雨夹雪；下冰雹
smog|n. 烟雾
smoggy|adj. 烟雾弥漫的
snowflake|n. 雪花
storm|n. 暴风雨；雷暴雨
stuffy|adj. 闷热的；不透气的；不通风的
swelter|v. 热得难受；中暑；n. 热昏；中暑
sweltering|adj. 酷热的；使人热得发昏的；v. 热得难受；中暑；“swelter”的现在分词
tepid|adj. 微温的；不冷不热的；不热情的
averse|adj. 不愿意的；反对的；嫌恶的
disapprove|v. 不赞成；反对；不同意
frown|v. 皱眉；蹙额；n. 皱眉；蹙额
hostility|n. 敌意；敌对；对抗
object|n. 物体；目的；对象；宾语；v. 反对；有意见；讨厌
objection|n. 反对；异议
opponent|n. 对手；反对者；敌手
agonize|v. 感到极度焦虑；折磨；苦苦思索
chew|v. 咀嚼
considerate|adj. 考虑周到的；体贴的
inconsiderate|adj. 不为别人着想的；不体谅别人的
contemplate|v. 考虑；深思；凝视；思考…的可能性
contemplation|n. 注视；沉思；打算
contemplative|adj. 沉思的；冥思的
haunt|v. 出没；萦绕；长期困扰；常去；n. 常到之地
recall|v. 召回；回忆起
meditate|v. 沉思；冥想；考虑；仔细计划
muse|v. 沉思；n. （作家、画家等的）灵感；缪斯
Muse|n. 缪斯（希腊女神）
nostalgic|adj. 怀旧的；乡愁的
pensive|adj. 沉思的；愁眉苦脸的
ponder|v. 深思；仔细考虑
preoccupation|n. 全神贯注；当务之急
recollect|v. 回想起；记起
recollection|n. 回忆；记忆；记忆力中的往事
speculation|n. 推测；猜测；投机买卖
speculative|adj. 推测的；推理的；思索的；投机的
common|adj. 常见的；普通的；共有的
mammal|n. 哺乳动物
mammalian|n. 温血动物；哺乳类动物；adj. 哺乳动物的
reptile|n. 爬行动物；adj. 爬虫类的
reptilian|adj. 像爬行动物的；令人讨厌的；n. 爬行动物
remote|adj. 偏远的；久远的；渺茫的；n. 遥控器
ancestor|n. 祖先；祖宗
marine|adj. 海的；与海有关的；n.  水兵；海军陆战队士兵；舰队；海运业
various|adj. 各种各样的；不同的；各种的
worm-like|adj. 似蠕虫的
creature|n. 生物；动物
primeval|adj. 远古的；原始的；出于原始天性的
bacteria|n. 细菌；“bacterium”的复数
clam|n. 蛤；沉默寡言的人
crab|n. 蟹；螃蟹；v. 抱怨；发牢骚
cuttlefish|n. 乌贼；墨鱼；墨斗鱼
dolphin|n. 海豚
jellyfish|n. 水母；海蜇；软弱无用的人
lobster|n. 龙虾
octopus|n. 章鱼
oyster|n. 牡蛎；蚝
plankton|n. 浮游生物
porpoise|n. 鼠海豚
prawn|n. 对虾；明虾；v. 捕虾
salmon|n. 鲑鱼；三文鱼；大马哈鱼
sardine|n. 沙丁鱼；沙丁鱼罐头
seagull|n. 海鸥
shrimp|n. 虾；小虾；矮小的人
starfish|n. 海星（一种海洋动物）
walrus|n. 海象
beak|n. 鸟喙
canary|n. 金丝雀；adj. 鲜黄色的
eagle|n. 鹰
falcon|n. 猎鹰
finch|n. 雀科鸣鸟；雀类
fowl|n. 家禽；鸟禽类
ostrich|n. 鸵鸟
peacock|n. 雄孔雀
turkey|n. 火鸡
vulture|n. 兀鹫；秃鹫；贪得无厌的人
aerobic|adj. 需氧的；好氧的；有氧的
anaerobic|adj. 厌氧的；无氧的
antibody|n. 抗体
bacillus|n. 杆状菌；杆菌
bacteriological|adj. 细菌学的
colonial|adj. 殖民地的；n. 殖民地居民
decline phase|phrase. 衰退期
decompose|v. 分解；使腐烂
degrade|v. 降级；降格；退化；降低…身份；使丢脸
disinfection|n. 消毒
disinfect|v. 消毒；杀菌
exponential growth|phrase. 指数式增长
fermentation|n. 发酵
ferment|n. 发酵；酵素；动乱；v. （使）发酵；动乱
fission|n. 分裂生殖；裂变；v. 分裂生殖；裂变
fissionable|adj. 可裂变的
fissility|n. 分裂性
fungus|n. 霉菌；菌类；真菌
germiculture|n. 细菌培养
inconspicuous|adj. 不引人注目的；不起眼的
infection|n. 感染；传染
invisible|adj. 看不见的；无形的
involution form|phrase. 退化型
log phase|phrase. 对数期
microbe|n. 微生物
microbiologist|n. 微生物学家
microorganism|n. 微生物
microscope|n. 显微镜
pathogen|n. 病原体；致病菌
pathogenic|adj. 能引起疾病的；病原的
rot away|phrase. 逐渐腐烂
stationary phase|phrase. 稳定期；固定相
sterilisation|n. 消毒杀菌；绝育；冲销
sterilise|v. 杀菌消毒；绝育
vaccine|n. 疫苗
vaccinate|v. 接种疫苗；预防接种
vaccination|n. 接种疫苗；种痘
virus|n. 病毒
viral|adj. 病毒性的；病毒引起的
finished|adj. 完成的；完蛋的；精湛的；v. 完成；结束；“finish”的过去式和过去分词
product|n. 产品；产物；成果；〈数〉积
dominate|v. 统治；支配；俯瞰
domination|n. 统治；控制；支配
flow|n. 流动；v. 流动
thanks to|phrase. 幸亏；由于；因为
technological|adj. 科技的；工艺的
lightweight|adj. 轻量的；无足轻重的；较轻的；n. 轻量级选手；不重要的人
component|n. 成分；部分；零件；adj. 组成的；构成的
ingredient|n. 成分；配料；要素；因素
tend to|phrase. 趋向；易于；往往
bulky|adj. 庞大的；肥大的； 体积大的
3D printer|phrase. 三维打印机
alter|v. 变更；改动
antivirus program|phrase. 反病毒程序；杀毒程序
appeal to|phrase. 呼吁；有吸引力；使感兴趣
artificial intelligence|phrase. 人工智能
cutting-edge technology|phrase. 尖端技术
digital age|phrase. 数字时代
engineering technology|phrase. 工程技术
future thinking|phrase. 未来思维；思考未来
high technology|phrase. 高科技
industrial structure|phrase. 产业结构
industrialise|v. 使工业化
inflatable|adj. 可充气的；可膨胀的；n. 可充气物品
intelligent system|phrase. 智能系统
nanometer|n. 纳米
precise|adj. 准确的；确切的
precisely|adv. 精确地；准确地；恰好地
precision|n. 精确；精密度
robot|n. 机器人
scientific theory|phrase. 科学理论
simulate|v. 假装；冒充；模仿；模拟
state-of-the-art|adj. ¸先进的；达到¸高水平的
strategic choice|phrase. 战略选择
technological development|phrase. 技术发展
technology|n. 科技；技术
telematics|n. 远程信息处理
unprecedented|adj. 无先例的；空前的；前所未有的
wireless technology|phrase. 无线技术
creative mind|phrase. 有创造力的头脑；创造性思维
curiosity|n. 好奇心
initiative|n. 自发性；主动权；倡议；措施
research and develop|phrase. 研发
revolutionise|v. 彻底变革；使革命化
scientific invention|phrase. 科学发明
scientific research|phrase. 科学研究
technical innovation|phrase. 技术革新
technical science|phrase. 技术科学
actual|adj. 真实的；实际的
construction|n. 建筑；建设
mainly|adv. 主要地；大部分地
massive|adj. 大而重的；大规模的
huge|adj. 巨大的
amounts of|phrase. 大量的
concrete|adj. 具体的；有形的；混凝土的；n. 混凝土；具体物；v. 用混凝土覆盖
dioxide|n. 二氧化物
manufacturing|n. 制造业；adj. 制造的；v. 制造；“manufacture”的现在分词
block|n. 块；街区；大楼；大厦；障碍物；v. 阻塞；阻碍
cottage|n. 村舍；小屋；小别墅
detached house|n. 独立式住宅
dormitory|n. 宿舍
high-rise flat|phrase. 高层公寓
hut|n. 小屋；棚屋；茅屋
mansion|n. 大厦；宅邸
multi-storey building|phrase. 多层建筑
ranch house|phrase. 牧场住宅；低矮平房
semi-detached house|phrase. 半独立式住宅
shanty|n. 简陋的小屋；水手号子
single-storey house|phrase. 平房；只有一层的房子
studio apartment|phrase. 单间公寓
terrace|n. 平台；梯田；阳台；v. 使成台地
terraced house|n. 连栋房屋
town house|phrase. （另有乡村住房的人的）城市住宅；连栋房屋
villa|n. 别墅
apartment|n. 单元住宅；公寓住宅
attic|n. 阁楼；顶楼
bathroom|n. 浴室；洗手间
bedroom|n. 卧室
bedsit|n. 卧室兼起居室
boardroom|n. （董事会）会议室
cellar|n. 地窖；地下室
corridor|n. 走廊
cramped|adj. 狭窄的；难认的；v. 束缚；使痉挛；用夹钳夹紧；“cramp”的过去式和过去分词
dining room|phrase. （家里或宾馆的）餐厅
garage|n. 车库；汽车修理厂
hall|n. 大厅；礼堂；门厅
hallway|n. 走廊；门厅；过道
laundry room|phrase. 洗衣间
living room|phrase. 客厅；起居室
lobby|v. 游说；n. 大厅；休息室
lounge|n. 休息室；长沙发；v. 懒洋洋地躺卧；闲逛；闲散度日
porch|n. 门廊
sanctum|n. 圣所；密室；私室
schoolroom|n. 教室
sewer|n. 下水道；排水沟；缝纫者
single room|phrase. 单人房间
skyscraper|n. 摩天大楼
to lay the foundation|phrase. 奠定基础；打下基础
storehouse|n. 仓库；储藏所；宝库
spacious|adj. 宽敞的；广阔的
evidence|n. 证据；证明
fascinating|adj. 极有吸引力的；迷人的
anecdote|n. 趣闻；轶事
anecdotal|adj. 轶事的；趣闻的；传闻的
similarity|n. 相像性；相似点
exception|n. 例外；除外
norm-referenced|phrase. 常模参照
analogy|n. 类比；类推；相似
analogous|adj. 相似的；类似的
likeness|n. 相似；相像
comparable|adj. 可比较的；比得上的；类似的
similar|adj. 类似的；相像的
like|v. 喜欢；prep. 像
homogeneous|adj. 同类的；相似的；均一的
kindred|n. 亲属；血缘关系；adj. 同源的；类似的
heterogeneous|adj. 异种的；异质的；由不同成份形成的
uniform|adj. 一致的；统一的；n. 制服
uniformity|n. 一致；同样；均¤
differ|v. 与…不同；与…相异
discriminate|v. 歧视；区别；区分
discrepancy|n. 差异；矛盾
difference|n. 差异；不同
distinctive|adj. 独特的；特别的；与众不同的
distinction|n. 区别；区分；优等评分
diverge|v. 叉开；分歧；相异
divergent|adj. 分歧的；叉开的；发散的；趋异的
diverse|adj. 多种多样的；不同的
diversity|n. 多样性；多样化
noticeably|adv. 明显地；引人注目地
prominence|n. 突出；重要；卓越；出名
transparent|adj. 透明的；显然的
absorbing|adj. 吸引人的；非常有趣的；v. 吸收；吸引；“absorb”的现在分词
addict|n. 瘾君子；入迷的人
addictive|adj. 使人上瘾的
addiction|n. 成瘾；沉溺；嗜好
allure|n. 诱惑；吸引；v. 诱惑；吸引
appealing|adj. 引起兴趣的；动人的；恳求的；v. 呼吁；吸引；诉请；“appeal”的现在分词
bait|n. 鱼饵；诱惑物；v. 下诱饵
charisma|n. 超凡魅力；感召力
charismatic|adj. 魅力非凡的
draw|v. 拉；拽；画；提取；吸引
engrossed|adj. 全神贯注的；v. 使全神贯注；独占；垄断；“engross”的过去式和过去分词
entice|v. 诱使；引诱
glamorous|adj. 富有魅力的；迷人的
grip|v. 紧握；掌握；吸引；n. 紧握；掌握；控制；把手
inviting|adj. 诱人的；吸引人的；v. 邀请；“invite”的现在分词
magnet|n. 磁体；磁铁
magnetism|n. 磁性；磁力；吸引力
magnetize|v. 使磁化；强烈吸引
mesmerize|v. 施以催眠术；迷住；迷惑
tempt|v. 诱惑；引诱；怂恿；劝诱
tempting|adj. 吸引人的；诱人的；v. 诱惑；引诱；怂恿；劝诱；“tempt”的现在分词
ethnography|n. 人种学；人种志
offer|n. 提议；提供；报价；v. 提供；愿意
insight|n. 洞察力；见识
present|n. 目前；礼物；adj. 在场的；目前的；v. 呈现；提出
current|n. （水、气、电）流；趋势；adj. 当前的；流通的
valuable|adj. 有价值的；贵重的；值钱的
invaluable|adj. 无价的；非常宝贵的
existing|adj. 现存的；现行的；v. 存在；生存；“exist”的现在分词
aboriginal|adj. 土著的；原始的；n. 土著居民
adult|n. 成人；adj. 成年的
antecedent|n. 前情；先行词；祖先（常复）；adj. 在 ... 之前的
anthropoid|adj. 像人类的（动物）；像猿猴的（人）
anthropology|n. 人类学
clan|n. 氏族；宗族
descent|n. 下降；斜坡；堕落；血统
ethnic|adj. 种族的；民族的；n. 少数民族的一员
exotic|adj. 外来的；外国来的；奇异的
native|adj. 本土的；当地的；天生的；n. 土著；本地人；本国人
forebear|n. 祖先；祖宗
forefather|n. 祖先；宗人
forerunner|n. 先行者；先驱；前兆
hybrid|n. 混合物；杂种；adj. 杂种的；混合的
indigenous|adj. 本土的；当地的
inexplicable|adj. 无法解释的；费解的
explicable|adj. 可说明的；可解释的
minority|n. 少数；少数民族；未成年人
paternity|n. 父亲的身份（或地位）
patriarch|n. 家长；族长；酋长
precursor|n. 先驱；先锋；先兆
predecessor|n. 前任；前辈；原有事物
race|n. 种族；赛跑；竞争；v. 比赛；快速移动
racial|adj. 种族的
ritual|n. （宗教等的）仪式；典礼；例行习惯；adj. 仪式的；惯常的；例行公事的
ceremony|n. 仪式；典礼
formality|n. 礼节；仪式；正式手续
social group|phrase. 社会群体；社会团体
stereotype|n. 刻板印象；陈规老套；v. 对…存有成见；把…模式化
stratification|n. 分层；形成阶层
taboo|n. 禁忌；忌讳；戒律；adj. 禁忌的；忌讳的；v. 禁忌
tribal|adj. 部落的；部族的
tribalism|n. 部落制度；部落主义；宗族主义
tribe|n. 部落；部族
entail|v. 需要；使…必然发生
indispensable|adj. 不可缺少的
necessity|n. 需要；必需品
prerequisite|n. 前提；先决条件；adj. 首要必备的
precondition|n. 前提；先决条件；v. 预先处理；事先准备
requisite|adj. 必需的；必备的；必不可少的；n. 必需品
hiring|n. 雇佣；租赁；adj. 雇佣的；租赁的；v. 雇用；租用；“hire”的现在分词
human resources|phrase. 人力资源；人事部门
document|n. 文件；公文；文献；v. 记录；为…提供证明
recognise|v. 认出；意识到；承认
realise|v. 实现；认识到；意识到
acquisitive|adj. 渴望获得的；贪得无厌的
attainable|adj. 可达到的；可获得的
gain|v. 获得；增加；n. 获得；增益
get|v. 得到；获得；使；收到；变得
obtain|v. 获得；得到
procure|v. 取得；获得；拉皮条
procurement|n. （为军队或其他组织的）采购
profit|n. 利润；收益；v. 获利；有益于
redeem|v. 兑现；赎回；挽回；履行；补偿；偿还
secure|adj. 安全的；可靠的；稳定的；v. （使）获得安全；担保；（使）获得
seize|v. 抓住；捉拿；夺取
accredited|adj. 可接受的；可信任的；被正式认可的；v. 归于；委托；授权；信任；“accredit”的过去式和过去分词
acknowledge|v. 承认；认可；告知收到；答谢
admission|n. 允许进入；承认
admit|v. 承认；允许进入
approve|v. 批准；认可；通过；赞成(连of)
authorize|v. 授权；委托；批准
avow|v. 承认；公开宣称声明
comply|v. 顺从；遵守
concede|v. 承认（失败）；让步
concession|n. 让步；（退一步）承认；特许权；减价票；销售场地；摊位
connivance|n. 默许；纵容；共谋
connive|v. 纵容；默许；共谋
grant|v. 允许；承认；授予；n. 授予物；补助金
take ... for granted|phrase. 认为…理所当然；想当然
nod|v. 点头；打盹；n. 点头
permissible|adj. 可容许的；可承认的
permit|v. 允许；准许；n. 通行证；许可证；执照
ratify|v. 批准；认可
reception|n. 接待；招待会
tacit|adj. 心照不宣的；不作声的
tolerate|v. 容忍；宽容
applicant|n. 申请人
between jobs|phrase. 暂时赋闲在家；暂时失业中
certificate|n. 证书；凭证；执照；v. 发给证明书；用证书证明（或认可）
collect information|phrase. 收集信息
credential|n. 证明书；资格证书；证件
CV|abbr. 简历；履历；“curriculum vitae”的缩写
curriculum vitae|phrase. 履历；简历
degree|n. 度；程度；学位
educational background|phrase. 教育背景
educational history|phrase. 学历
face-to-face|adj. 面对面的；adv. 面对面地
headhunting company|phrase. 猎头公司
hobby|n. 爱好
hunt|v. 打猎；搜寻
job description|phrase. 职位描述；工作描述；职责说明
job fair|phrase. 招聘会
job hunting|n. 求职
job opportunity|phrase. 就业机会
job hunter|phrase. 求职者
opening|n. 开始；开口；空缺职位；adj. 开始的；v. 打开；“open”的现在分词
profile|n. 侧面像；轮廓；简介；受公众注意的程度
qualification|n. 资格；条件
qualified|adj. 有资格的；合格的；有保留的；有限制的；v. 取得资格；“qualify”的过去式和过去分词
résumé|n. 简历；履历
seize the opportunity|phrase. 抓住机会
unemployed|adj. 失业的；待业的；下岗的
vacant position|phrase. 职位空缺
vocational guidance|phrase. 职业指导
impression|n. 印象
comprehensive|adj. 全面的；广泛的；综合的；详尽的
coverage|n. 覆盖范围；新闻报道
render|v. 使变得；给予；（以某种方式）表达；翻译
rendering|n. 演奏；翻译；表演；v. 提供；给予；“render”的现在分词
alumna|n. 女毕业生；女校友
arts|n. 人文学科；文科
award|v. 颁奖；授予；裁定；n. 奖品；裁定
chancellor|n. 大臣；总理
compulsory|adj. 强制的；必须做的
enforced|adj. 强迫的；强制性的；v. 强制；执行；加强；“enforce”的过去式和过去分词
confer|v. 授予；赋予；商讨
curriculum|n. 课程
dais|n. 讲台
didactic|adj. 教诲的；说教的；好教训人的
elective|adj. 选举的；选修的；可选择的；n. 选修课程
enlighten|v. 启发；开导
enroll|v. 登记；注册；招收；录取
extracurricular|adj. 正课以外的；课外的
faculty|n. 才能；能力；全体教员；院系
heuristic|adj. 启发式的；探索的；n. 启发式教学
humanities|n. 人文学科
illiteracy|n. 文盲；无知；缺乏教育
inculcate|v. 反复灌输；谆谆劝导
instruct|v. 教授；教导；指示；命令；通知
teach|v. 教；教导
internationalization|n. 国际化
literacy|n. 识字；有读写能力；有文化
matriculate|v. 准许入学；被录取入学
minor|adj. 小的；次要的；轻微的；小调的；n. 未成年人
mobility|n. 流动性；灵活性；迁移率
obligatory|adj. 强制性的；义务的；必须的
optional|adj. 可选择的；非强制的
rostrum|n. 讲坛；指挥台；领奖台
rote learning|phrase. 死记硬背式学习；机械学习
scholarship|n. 奖学金；学问；学识
science|n. 科学
secondary|adj. 第二的，次要的；中等的
semester|n. 一学期；半学年
specialty|n. 专业；专长；特色食品
subject|n. 主题；话题；学科；对象
symposium|n. 专题讨论会；研讨会
tertiary|adj. 第三的；高等教育的
tuition|n. 指导；学费
universal|adj. 普遍的；全体的
vocational|adj. 职业的
sleeper|n. 睡眠者；枕木；卧铺
availability|n. 可用性；可获得性
booking|n. 预订；预约；v. 预订；“book”的现在分词
two-berth|phrase. 双卧铺
cabin|n. 小棚屋；船舱；客舱
except|conj. 除了；只是；v. 不计；把…除外；prep. 除了；除外
exceptional|adj. 卓越的；杰出的；罕见的；特别的
in the case of|phrase. 至于；就…来说；在...的情况
solo|n. 独奏；独唱；独舞；单独表演；adj. 单独的；独唱的；独奏的；adv. 单独地；独自地；独奏地
include|v. 包括；包含
fare|n. 车费；票价；费用；v. 进展；成功（或不成功等）
agency|n. 机构；局；代理处
atlas|n. 地图册；地图集
backpack|n. 背包；背囊
knapsack|n. 小背包
coach|n. 教练；长途客运汽车；火车车厢；v. 训练；培训
excursion|n. 远足；短途旅行；涉猎某事
expedition|n. 远征；探险；探险队；短途旅行；迅速
guide|v. 指导；指引；n. 指南；向导；导游
hike|n. 远足；（费用）增加；v. 远足；（费用）增加
hostel|n. 旅社；招待所；（校外）学生宿舍
itinerary|n. 路线；旅程
route|n. 路线；途径
path|n. 道路；小路；小径
tram|n. 电车；缆车；v. 乘电车；乘缆车
trip|n. 旅行；旅程；v. 绊倒；出差错；轻快地走
vehicle|n. 车辆；交通工具；媒介物；传达手段
visa|n. 签证
charge|v. 使承担责任；收费；充电；指控；给…充电；n. 负责；收费；指控；谴责
cost|v. 花费；n. 费用；代价
expense|n. 费用；开支
fee|n. 费用
price|n. 价格；代价；v. 定价
pricey|adj. 价格高的；昂贵的
besides|adv. 此外；而且；还；prep. 除…以外；还
extraordinary|adj. 不平常的；非凡的
outstanding|adj. 杰出的；尚未处理的
unusual|adj. 不平常的；不寻常的
exclude|v. 拒绝；排斥；排除
exclusion|n. 排除；排斥；被排除在外的事物
exclusive|adj. 独有的；高级的；排外的
extra|adj. 额外的；adv. 额外地；n. 额外的事物
spare|adj. 多余的；空闲的；备用的；瘦削的；简陋的；v. 节省；抽出；分让；宽恕；使免遭
extraneous|adj. 外来的；无关的
principle|n. 原则；原理
turbine|n. 涡轮
tidal|adj. 有潮的；受潮水影响的
blade|n. £刃；桨叶
propeller|n. 螺旋桨；推进器
tide|n. 潮汐；潮流
predictable|adj. 可预见的；可预料的
input|n. 输入；v. 输入
constant|adj. 恒定的；不变的；持续的；n. 常数；常量
constancy|n. 坚定不移；持久不变
dampen|v. 使潮湿；使沮丧；抑制；减弱
dip|v. 浸；蘸；（暂时）减少；n. 浸；蘸；下降
drift|v. 飘；漂流；漂移；n. 流动；趋势
float|v. 浮动；漂浮
drifter|n. 流浪者
exude|v. 溢出；渗出；显露
gush|v. 喷涌；滔滔不绝地说；n. 涌出；喷出
immerse|v. 浸；陷入；沉浸于
influx|n. 流入；涌入
infuse|v. 注入；泡制；灌输
meander|v. 缓慢而弯曲地流动；漫步；闲聊；n. 河流的曲折；漫步；迂回曲折的进程
moisten|v. 湿润；变湿
humidify|v. 使潮湿；使湿润
overflow|v. 泛滥；溢出；充满；n. 泛滥；溢出
saturate|v. 使浸透；使湿透；使满；使饱和
drench|v. 使湿透；浸透；n. 弄湿；浸液
soak|v. 浸泡；吸收；n. 浸泡
splash|v. 溅；泼；n. 引人注目的人或物；溅污的斑点
splatter|v. 溅泼；飞溅；说话结巴；n. 液体的飞溅
sprinkle|v. 洒；撒；下小雨；n. 洒；撒；小雨；少量
spout|n. 喷口；水管；水柱；v. 喷出；滔滔不绝地说
spray|n. 喷雾；v. 喷洒
spurt|v. 喷射；迸发；突然加速努力；n. 迸发；喷出；突然一阵
submerge|v. 潜水；浸没
forecast|n. 预测；预报；v. 预测；预报
foresee|v. 预见；预知
predict|v. 预言；预测
foresight|n. 先见；预见；先见之明
foretell|v. 预言；预示；预卜
imminent|adj. 即将发生的；临近的
prediction|n. 预测；预言；预告
hopeful|adj. 有希望的
bright|adj. 明亮的；鲜艳的；聪明的
hopeless|adj. 绝望的
prospect|n. 展望；前景；希望；v. 勘探；寻找
prospective|adj. 预期的；潜在的；可能发生的
anticipated|adj. 预先的；预期的；v. 预料；预期；期望；“anticipate”的过去式和过去分词
provident|adj. 有先见之明的；深谋远虑的
surmise|v. 臆测；猜想；n. 臆测；猜度
tendency|n. 趋势；倾向
known as|phrase. 被称为；公认为
neuroeconomics|n. 脑神经经济学
study|v. 学习；研究；n. 学习；研究；书房
success|n. 成功；胜利
economic|adj. 经济（上）的；可赚钱的
environment|n. 环境
demand|n. 要求；请求；需求；v. 要求；请求；需求
innovation|n. 创新；改革
novelty|n. 新奇（的事物）；小玩意
reformation|n. 革新；改善
able|adj. 能…的；有能力的；能够
differently|adv. 不同地；有差别地
competitor|n. 竞争者
competition|n. 竞争；比赛
affluence|n. 富裕；丰富
scarcity|n. 缺乏；不足；缺少
deficiency|n. 缺乏；不足
bankruptcy|n. 破产；倒闭；无偿付能力
brand|n. 品牌；商标；烙印；v. 侮辱；铭刻于； 加商标于；打烙印于
name-brand|adj. 名牌的
budget|n. 预算；预算金额；v. 为 ... 做预算；节省开支；adj. 廉价的；花钱少的
collateral|adj. 并行的；附属的；旁系的；n. 抵押品；担保品；旁系亲属
currency|n. 货币；流通
deflation|n. 通货紧缩；放气
enterprise|n. 事业；企业；进取心
expenditure|n. 开支；消费；耗费
financial|adj. 财政的；金融的
industrialisation|n. 工业化；产业化
monetary|adj. 货币的；金钱的
patronage|n. 赞助；惠顾；委任权
poverty|n. 贫困；短缺
privatise|v. 使私有化；将…私营化
profitability|n. 盈利能力；盈利性；收益率
prosperity|n. 繁荣；兴旺
quota|n. 配额；限额；定额
allotment|n. 分配物；份额；拨款
ransom|n. 赎金；v. 赎回
refund|v. 退还；偿还；n. 退款；返还款
sponsorship|n. 资助；赞助
stock|n. 库存；股票；家畜；v. 备有；贮存
surplus|n. 过剩；盈余；adj. 过剩的
unemployment|n. 失业
detrimental|adj. 有害的；不利的；损害的
effectively|adv. 有效地；实际上
effectiveness|n. 有效性；效力
ineffective|adj. 无效果的；不起作用的；不奏效的
noise|n. 噪声；噪音
situation|n. 情况；形势；情境
limit|n. 限制；v. 限制
disability|n. 无能力；失去能力；伤残
speech|n. 讲话；演说；发言
verbal|adj. 口头的；语言的；用词的；动词的
communication|n. 通信；交流
extremely|adv. 非常地；极其地；极端地
exceptionally|adv. 例外地；异常地；特殊地
intensely|adv. 强烈地；极度；剧烈地
bondage|n. 束缚；奴役
bound|adj. 一定会；有义务的；密切相关的；准备前往；v. 受…限制；v. 捆绑；“bind”的过去式和过去分词
circumscribe|v. 在...周围画线；限制；画外接圆
confine|v. 限制；监禁
fetter|v. 为 ... 上脚镣；束缚；限制；n. 脚镣；桎梏；束缚
quell|v. 压制；平息；消除；减轻
restraint|n. 约束；抑制；克制
restrict|v. 限制；约束
temperance|n. 节欲；戒酒；禁酒
consort|n. （统治者的）配偶；一组；v. 厮混；结交
correspondence|n. 通信联系；符合；一致
disseminate|v. 传播；散播；扩散
impart|v. 传授；给予；告知
liaison|n. 联络；联系；通奸
propagate|v. 繁殖；增殖；传播
propagation|n. 传播；繁殖；增殖
reciprocal|adj. 互惠的；相互的；倒数的；n. 倒数
boredom|n. 无聊；厌倦；厌烦
boring|adj. 无聊的；令人厌倦的；v. 开凿；钻孔；使厌烦； “bore”的现在分词
bothersome|adj. 令人厌烦的；令人烦恼的
disarrange|v. 使紊乱；使混乱；弄乱
distract|v. 转移；分散；使分心
gloomy|adj. 黑暗的；幽暗的；忧郁的；沮丧的
harass|v. 骚扰；烦扰；屡次侵扰
uproar|n. 喧嚣；骚动；吵闹
vex|v. 使恼火；使烦恼
transit|n. 运输；中转；运送；v. 通过；经过；中转
widely-separated|adj. 相隔甚远的；大有分别的；稀疏的
location|n. 位置；地点
place|n. 地方；方位；v. 安置；安放
spot|n. 斑点；圆点；地点；场所；v. 识别；发现；弄脏
astronomer|n. 天文学家
astronomy|n. 天文学
calculate|v. 计算；推测
calculation|n. 计算；计算结果；慎思；考虑
parallax|n. 视差
angle|n. 角；角度；视角；v. 斜放；运用手段获得
angular|adj. 角的；有角的；尖角的；瘦骨嶙峋的
apparent|adj. 明显的；显然的；表面上的
apparently|adv. 据说；似乎；显然地
position|n. 位置；姿势；地位；职位；v. 安置；定位
astronomical|adj. 天文学的；巨大的
observer|n. 观测者；观察员
marked|adj. 明显的；显著的；有记号的；v. 做标记；（使）留痕迹；评分；“mark”的过去式和过去分词
markedly|adv. 显著地；引人注目地
pronounced|adj. 显著的；断然的；明确的；v. 发音；宣告；“pronounce”的过去式和过去分词
sensible|adj. 明智的；有判断力的；恰当的；合理的
sensibility|n. 敏感性；感受力；善感；感情
aerolite|n. 陨石
asteroid|n. 小行星
celestial|adj. 天空的；天体的；天国的
comet|n. 彗星
constellation|n. 星座；一群杰出人物；一系列（相关的想法、事物）
cosmic|adj. 宇宙的；极广阔的
cosmos|n. 宇宙
eclipse|n. 日食；月食；黯然失色；v. 使失色
galaxy|n. 星系；银河；银河系；一群出色的人（或物）
infinite|adj. 无穷的；无限的
intergalactic|adj. 银河间的
interplanetary|adj. 行星间的；太阳系内的
interstellar|adj. 星际的
Jupiter|n. 木星；朱庇特
land|n. 土地；陆地；v. 降落；着陆
launch|v. 发射；发起；启动；掷；n. 发射；投掷；启动
launcher|n. 发射器；启动器；发射台
lunar|adj. 月球的；月亮的；阴历的
Mars|n. 火星
meteor|n. 流星；大气现象
nebula|n. 星云
orbit|n. 轨道；v. 绕...轨道而行
planet|n. 行星
polestar|n. 北极星
revolve|v. 旋转；考虑；围绕
satellite|n. 卫星；人造卫星
star|n. 星；恒星；明星
stellar|adj. 星的；星球的；主要的；一流的
universe|n. 宇宙
Venus|n. 金星；维纳斯
victimise|v. 使受害
pupil|n. 小学生；瞳孔
difficulty|n. 困难；艰难
interpersonal|adj. 人与人之间的；人际关系的
relationship|n. 关系；联系；亲戚关系
while|conj. 当…的时候；尽管；然而；n. 一会儿；一段时间
persistently|adv. 坚持地；锲而不舍地；一直
bully|v. 恐吓；威迫；欺负；n. 仗势欺人者；横行霸道者
grow up|phrase. 长大；成熟；成长
physically|adv. 身体上；物质上；体格上
radical|adj. 根本的；彻底的；激进的；n. 激进分子
convict|v. 定罪；宣判有罪；n. 罪犯；囚犯
anti-social|adj. 反社会的
offence|n. 冒犯；犯罪
bosom friend|phrase. 知己
buddy|n. 老兄；伙计；同伴
colleague|n. 同事
companion|n. 同伴；伴侣
comrade-in-arms|phrase. 战友
confidante|n. 女性知己
mentor|n. 导师；顾问；v. 指导；辅导
partner|n. 合伙人；搭档
pen pal|phrase. 笔友
sworn brother|phrase. 结拜兄弟；死党
blunt|adj. 不锋利的；耿直的；v. 使变钝
bluntly|adv. 坦率地；率直地
contact|n. 接触；联系；v. 接触；联系
couple|n. （一）对；几个；夫妻；v. 连合；连接；结合
cultural difference|phrase. 文化差异
easy-going|adj. 随和的；容易相处的
extroverted|adj. 外向的；喜欢交际的
fellow-apprentice|n. 师兄弟；同门；同修
harmony|n. 和谐；协调
introverted|adj. 内向的
offend|v. 冒犯；得罪；违反；犯罪
social skill|phrase. 社交能力；社交技能
abuse|v. 滥用；虐待；辱骂；n. 滥用；虐待；辱骂
campus violence|phrase. 校园暴力
school bullying|phrase. 校园欺凌
classmate|n. 同班同学；同学
cruel|adj. 残酷的；冷酷的
fight|v. 打架；战斗；n. 打架；战斗
ill-treat|v. 虐待
juvenile delinquency|phrase. 青少年犯罪
maltreat|v. 虐待
slap|v. 拍；掴；拍击；n. 拍；掴；拍击
aggressive behaviour|phrase. 攻击性行为；激进行为
antisocial behaviour|phrase. 反社会行为
commit crimes|phrase. 犯罪
domestic violence|phrase. 家庭暴力
forcible|adj. 强制的；强迫的；强有力的
gangster|n. 歹徒；匪徒；暴徒
life imprisonment|phrase. 终生监禁；无期徒刑
malice|n. 恶意；怨恨；蓄意
motive for crime|phrase. 犯罪动机
punishment|n. 处罚；惩罚
school shooting|phrase. 校园枪击（案）
the incidence of crime|phrase. 犯罪率
to fight crime|phrase. 打击犯罪
violate|v. 违反；侵犯
violation|n. 违反；妨碍；侵犯；违背
violence|n. 暴力；暴行
violent inclination|phrase. 暴力倾向
abduction|n. 诱拐；绑架
adultery|n. 通奸；婚外性行为
breach|n. 缺口；破裂；违背；v. 在…上造成缺口；违反；攻破
bribery|n. 受贿；行贿
calumny|n. 诬蔑；诽谤；中伤
contravene|v. 违反；触犯
corruption|n. 贪污；堕落；腐败
delinquency|n. （常指青年人的）犯罪
embezzlement|n. 盗用公款；贪污；挪用
harbour|n. 海港；v. 庇护；窝藏
homicide|n. 凶杀；杀人
larceny|n. 盗窃（罪）
perjury|n. 伪证；伪证罪
slander|v. 诋毁；诽谤；中伤；n. 诋毁；诽谤；中伤
smuggle|v. 走私；偷运
swindle|v. 诈骗；骗取；n. 诈取；骗局
negative|adj. 否定的；消极的；负面的；n. 否定的表达；负数；底片
organisation|n. 机构；组织；安排，筹备
depend|v. 依靠；依赖；取决于
dependable|adj. 可信赖的；可靠的
decision|n. 决定；抉择；选择
efficient|adj. 效率高的
efficiency|n. 效率；功效
charity|n. 慈善；慈善团体
commonwealth|n. 联邦；共和国；联合体
company|n. 公司；陪伴
denomination|n. 宗派；教派；面额
institution|n. 机构；风俗；制度；制定
organize|v. 组织；安排
arrange|v. 安排，排列；改编（乐曲）
incur|v. 招致；遭受
inflict|v. 把…强加给；使遭受；使承受
infliction|n. 施以；使负担
suffer|v. 遭受；忍受
withstand|v. 抵挡；经受住
ambassador|n. 大使
aristocrat|n. 贵族
autocrat|n. 独裁者
commander|n. 司令官；指挥官
congressman|n. 国会议员；众议员
congresswoman|n. 众议院女议员；国会女议员
consul|n. 领事
democrat|n. 民主主义者；民主党员
dictator|n. 独裁者；专制者
emperor|n. 皇帝；帝王
envoy|n. 使节；特使；外交使节
feminist|n. 女权主义者；adj. 女权主义的
minister|n. 部长；大臣；牧师
monarch|n. 君主；帝王
monarchy|n. 君主制；君主政体；君主国
president|n. 总统；总裁；主持人；校长；行长
chairman|n. 主席；主持人；董事长
republican|adj. 共和国的；共和政体的；n. 共和党人
advocator|n. 拥护者；提倡者
arbitrator|n. 仲裁人；公断人
attorney|n. 律师；辩护律师；代理人
jury|n. 陪审团；评委会
lawyer|n. 律师
solicitor|n. 事务律师；初级律师
alumnus|n. 男毕业生；男校友
dean|n. 学院院长；系主任
lecturer|n. 演讲者；讲师；授课老师
professor|n. 教授；导师
agent|n. 代理人；经纪人；动因；特工；（药）剂
apprentice|n. 学徒；徒弟；v. 使当学徒
apprenticeship|n. 学徒期；学徒身份
attendant|n. 服务人员；adj. 伴随的
auditor|n. 审计员；（大学课程的）旁听生；（一名）听众
co-worker|n. 同事；共同工作者
delegate|v. 委派；授权；n. 代表
deputy|n. 代理人；副手
novice|n. 新手；初学者；新信徒
proprietor|n. 所有者；经营者 ；业主
proxy|n. 代理人；代表；代理权；代理服务器
representative|n. 代表；典型事物；adj. 典型的；有代表性的；代议制的
adherent|n. 拥护者；信徒；adj. 黏附…的
atheist|n. 无神论者
believer|n. 信仰者；信徒；相信…者
clergy|n. 神职人员
disciple|n. 信徒；弟子；门徒
skeptic|n. 怀疑论者；怀疑宗教主张的人；无神论者
zealot|n. 热心者；狂热者
assassin|n. 暗杀者；刺客
bandit|n. 强盗；土匪；盗匪
barbarian|n. 野蛮人；adj. 野蛮的
burglar|n. 窃贼；夜盗
robber|n. 强盗；抢劫犯；盗贼
exile|n. 流放；放逐；流亡；v. 流放；放逐；流亡
figurehead|n. 装饰船头的人像；傀儡领袖；有名无实的首脑
foe|n. 敌人；仇敌
malcontent|adj. 不满的；不服的；n. 不满现状的人；反抗者
artisan|n. 技工；工匠
artist|n. 艺术家；画家
aviator|n. 飞行员；飞机驾驶员
biographer|n. 传记作者
biography|n. 传记
choreographer|n. 舞蹈指导；编舞者
connoisseur|n. 鉴识家；内行
critic|n. 评论家；批评者
educator|n. 教育家；教育者
pilot|n. 飞行员；驾驶员
benefactor|n. 恩人；捐助者；赠送者
beneficiary|n. 受益人
donor|n. 捐赠者；赠与者
humanitarian|n. 人道主义者；慈善家；adj. 人道主义的；慈善的
resident|n. 常住居民；adj. 居住的；常驻的
spectator|n. 观众；旁观者
viewer|n. 观察者；观看者；电视观众
audience|n. 观众；听众
create|v. 创造；创作
creation|n. 创作；创造物
link|n. 连接物；链环；v. 连接；联系
database|n. 数据库；信息库
feed|v. 喂；吃；饲养；n. 饲养；喂养
measurement|n. 衡量；测量
survey|v. 调查；勘测；n. 调查；勘测
field survey|phrase. 实地调查；实地考察
drone|n. 雄蜂；嗡嗡声；絮叨；寄生虫；无人驾驶飞机；v. 嗡嗡响；絮絮叨叨地说；混日子
satellite imagery|phrase. 卫星图像
real-time|adj. 实时的；接到指示立即执行的
data|n. 数据；资料
agrarian|adj. 土地的；耕地的；农业的
arable|adj. 可耕的；适于耕种
arid|adj. 干旱的；贫瘠的；枯燥无趣的
bleak|adj. 荒凉的；阴冷的；凄凉的；无望的；沮丧的
cold|n. 寒冷；感冒；adj. 寒冷的；冰冷的
dismal|adj. 阴沉的；抑郁的；沮丧的
clay|n. 黏土；粘土
clod|n. 大泥块；大土块；笨蛋；傻瓜
contaminated land|phrase. 污染的土地
contaminated soil|phrase. 污染土壤
desert|n. 沙漠；荒漠；v. 抛弃
infertile|adj. 不育的；不结果实的；贫瘠的
fertile|adj. 肥沃的；多产的；富饶的；有繁殖力的
land carrying capacity|phrase. 土地资源承载力
sterile|adj. 不能生育的；无菌的；贫瘠的
topsoil|n. 表土；表土层
provide|v. 提供；供应
accommodate|v. 容纳；为...提供住宿；适应
furnish|v. 布置家具；配备；供给；提供
unfurnish|v. 搬走...的家具；拆除...的家具
provision|n. 供应；预备；储粮；规定；条款
preparation|n. 准备；预备
enquire|v. 询问；调查
fieldwork|n. 野外考察；实地调查
investigate|v. 调查；研究
observation|n. 观察；观测；注意；监视；（观察后的）意见
observational|adj. 观察的；观测的
observe|v. 观察；注意到；遵守；评论；庆祝
perspective|n. 视角；观点；（对事物的）合理判断；透视；（远）景
probe|n. 探针；探测器；探究；v. 探究；探查
questionary|n. 调查表；adj. 询问的
continue|v. 继续；连续
discontinue|v. 停止；终止；中断
National Trust|n. 国民托管组织（英国保护名胜古迹的私人组织）
conservator|n. 文物保护者
mobilise|v. 调动；动员
local|adj. 局部的；本地的
stationer|n. 文具商
especially|adv. 尤其；特别；专门
bulk|n. 巨大的东西；大量；大部分；体积
blotting paper|phrase. 吸墨纸
desperately|adv. 绝望地；拼命地；不顾一切地；极度地
anguish|n. （身体或精神的）极度痛苦
avalanche|n. 雪崩；纷至沓来
calamity|n. 大灾祸；灾难
casualty|n. 伤亡（人数）；受伤的人；事故；临时救治所；急诊室
cataclysm|n. 大灾难；洪水；剧变
catastrophe|n. 灾难
catastrophic|adj. 灾难性的
debris|n. 碎片；残骸；残渣
deluge|n. 大洪水；暴雨；泛滥；v. 泛滥；大量涌入
destroy|v. 破坏；摧毁
disaster|n. 灾害；灾难
disastrous|adj. 灾难性的
famine|n. 饥荒
massacre|v. 屠杀 ；n. 大屠杀
misfortune|n. 不幸；灾祸
fortune|n. 命运；财产；运气
mishap|n. 不幸之事；灾祸；恶运
slaughter|v. 屠宰；屠杀；n. 屠宰；屠杀
persecute|v. 迫害；烦扰
unfortunate|adj. 不幸的；倒霉的；n. 不幸的人
upheaval|n. 剧变；动乱
victim|n. 受害者
sacrifice|v. 牺牲；献出；供奉；n. 供奉；祭品；牺牲（品）
wreckage|n. 破片；残骸
impulse|n. 冲动；脉冲；冲动力
impulsive|adj. 凭冲动行事的；易冲动的
momentum|n. 动量；冲力；推进力；动力；势头
motivate|v. 引起动机；激发；激励
motivation|n. 动机；动力
motivational|adj. 激发性的；动机的
motive|n. 动机；目的
accidental explosion|phrase. 意外爆炸
alarm bell|phrase. 警铃；警钟
blast|n. 爆炸；一阵强劲的气流；突然的响声；v. 爆破；产生巨大噪声
burning area|phrase. 燃烧区域；燃烧面积
burning intensity|phrase. 燃烧强度
collapse|v. 倒塌；昏倒；暴跌；折叠；n. 倒塌；崩溃；病倒；暴跌
combustible|adj. 易燃的；燃烧性的；易激动的；n. 燃质物；可燃物
death by burning|phrase. 火刑；烧死
death count|phrase. 死亡人数
devastating effect|phrase. 毁灭性影响
elevated temperature|phrase. 高温
elevator|n. 电梯；升降机
emergency exit|phrase. 紧急出口
extinguish|v. 熄灭；扑灭
fire alarm|phrase. 火警
fire engine access|phrase. 消防通道
fire engine|phrase. 消防车
fire extinguisher|phrase. 灭火器
fire hydrant|phrase. 消防栓
fire injury|phrase. 火灾伤害
fire inspection|phrase. 消防检查
fire insurance|phrase. 火灾保险
fire telephone|phrase. 火警电话；消防电话
firefighting|n. 消防；防火
fireman|n. 消防队员
firefighter|n. 消防员
first aid telephone|phrase. 急救电话
first aid|phrase. 急救
inhibition|n.  禁止；抑制；压抑
lifesaver|n. 救命者；水难救生员；济急的人
origin of the fire|phrase. 火源
oxygen deficiency|phrase. 缺氧
perish|v. 死；暴卒；毁灭
poisonous atmosphere|phrase. 有毒的空气；紧张的氛围
refuge|n. 避难所；庇护
relief work|phrase. 救济工作
rescue|n. 救援；营救；v. 救援；营救
save|v. 保存；节省；拯救；prep. 除...之外；除了；conj. 若不是；除了
self-contained breathing equipment|phrase. 自给式呼吸设备
smoke|v. 抽烟；冒烟；n. 烟；烟雾
stair|n. 楼梯；梯级
suffocation|n. 窒息；闷死
water|n. 水；v. 给…浇水；给（某地）供水
physics|n. 物理学
immense|adj. 巨大的
demonstrate|v. 演示；展示；证明；示威
illustrate|v. （举例）说明；给（书籍、杂志等）加插图
subsequent|adj. 随后的；后来的
subsequently|adv. 随后；后来
nuclear|adj. 原子能的；核能的
physicist|n. 物理学家
chemist|n. 化学家； 药剂师
colossal|adj. 巨大的；庞大的
enormous|adj. 巨大的；庞大的；大量的
enormously|adv. 极度；大量
gigantic|adj. 巨大的；庞大的
tiny|adj. 极小的；微小的；微量的
microscopic|adj. 显微镜的；极小的；微观的
immeasurable|adj. 不可估量的；不可测量的；无限的
incalculable|adj. 无数的；不可计算的；不可预料的
mammoth|adj. 巨大的；庞大的；n. 猛玛（象）；庞然大物
mighty|adj. 强大的；有力的；巨大的；adv. 非常；很；极其
prodigious|adj. 巨大的；惊人的；奇异的
tremendous|adj. 巨大的；极大的
vast|adj. 巨大的；辽阔的
vastness|n. 巨大；广阔
vastly|adv. 极大地；非常地
celebrated|adj. 著名的；v. 庆祝；“celebrate”的过去式和过去分词
complimentary|adj. 赞美的；称赞的；免费赠送的
eminent|adj. 著名的；非凡的；杰出的
entitle|v. 授权；命名；给...权利（或资格）
laudable|adj. 应受赞扬的；值得赞美的
legendary|adj. 传奇的；传说的；享有盛名的
lofty|adj. 高的；崇高的；傲慢的
matchless|adj. 无与伦比的；无双的；无可匹敌的
notable|adj. 值得注意的；显著的；著名的；n. 名人；显要人物
notably|adv. 显著地；尤其；特别地
noteworthy|adj. 值得注意的；显著的
noted|adj. 著名的；闻名的；显著的；v. 注意；备注；“note”的过去式和过去分词
pre-eminent|adj. 杰出的；卓越的；出类拔萃的
prominent|adj. 突出的；显著的；杰出的
renowned|adj. 有名的；有声誉的
supreme|adj. 至上的；¸高的
commend|v. 推荐；表扬；举荐
compliment|v. 称赞；恭维；n. 称赞；恭维
laud|v. 称赞；赞美；n. 赞颂；赞美
deference|n. 尊重；遵从；听从
dignify|v. 使有尊严；使崇高；使显贵
dignified|adj. 高贵的；有尊严的
prestige|n. 声望；威望；威信
respect|v. 尊重；尊敬；遵从；n. 尊重；尊敬；方面
respectable|adj. 可敬的；值得尊敬的；体面的；可观的
revere|v. 尊敬；敬畏
reverence|n. 尊敬；尊崇
accelerator|n. 加速器；油门；促进剂
atom|n. 原子
beam|n. 光线；横梁；v. 眉开眼笑；发射（电波或光）
chafe|v. 摩擦；擦痛；惹怒；n. 擦伤；激怒
clutter|n. 杂乱；混乱；v. 弄乱
cohesion|n. 内聚性；团结；凝聚力
concave|adj. 凹的；凹面的
conduction|n. （热或电等能量的）传导；导热；导电
convex|adj. 凸出的；凸面的
decelerate|v. （使）减速
declivity|n. 斜坡；坡度；下斜
dilute|v. 稀释；adj. 经稀释的
distillation|n. 蒸馏（过程）；净化（过程）；升华
elasticity|n. 弹性；伸缩性
elastic|adj. 有弹性的；灵活的
electricity|n. 电学；电力
electron|n. 电子
focus|n. 中心点；焦点；v. 集中；聚焦
gravity|n. 重力；地心引力；严重性
inertia|n. 惯性；惰性
intensity|n. 强度；强烈；剧烈
liquid|n. 液体；adj. 液体的；液态的
magnetic|adj. 磁性的；有吸引力的
matter|n. 事情；物质；问题；麻烦；v. 要紧
mechanics|n. 力学；机械学；构成法；运作方式；n. 技工；机械师；机修工；“mechanic”的复数
neutron|n. 中子
nucleus|n. 核心；核子
precipitate|v. 使发生；沉淀；凝结；猛摔；n. 沉淀物；冷凝物；adj. 迅猛的；贸然轻率的
pressure|n. 压力；压强；压迫；v. 对…施加压力
proton|n. 质子
quantum|n. 量子
refraction|n. 折光；折射
resonance|n. 共鸣；共振；反响
solid|n. 固体；立体图形；adj. 固体的；坚固的；可靠的
temperature|n. 温度；气温；体温
thaw|v. 使融解；解冻；变缓和；n. 融雪
thermodynamics|n. 热力学
thermometer|n. 温度计；体温表
vector|n. 向量；矢量；带菌媒介；航向
velocity|n. 速度；速率；迅速
speed|n. 速度；速率；v. 加速；加快
rapidity|n. 迅速；急速
ventilation|n. 通风；通风装置
taxonomist|n. 分类学者
taxonomy|n. 分类学；（动、植物）分类
overlook|v. 忽略；俯视
forget|v. 忘记；遗忘
ecology|n. 生态；生态学
limited|adj. 有限的；v. 限制；“limit”的过去式和过去分词
specimen|n. 标本；样品
sample|n. 样品；样本；v. 尝试，体验；抽样；节录
taxonomic|phrase. 分类学的；分类的
investigation|n. 调查； 研究
devalue|v. 使贬值；贬低
estimate|v. 估算；估价；n. 估价；估算
ETA|abbr. 预计到达时间；“estimated time of arrival”的缩写
ETD|abbr. 预计离开时间；“Estimated Time of Departure”的缩写
evaluate|v. 估价；评价
profitable|adj. 有益的；有利可图的
unprofitable|adj. 不赢利的；无利可图的；没有用的
worthless|adj. 无价值的
worthy|adj. 值得尊敬的；值得…的
unworthy|adj. 不值得的；不配的；与…不相称的；不应得的
behalf|n. 代表；利益；支持
bolster|v. 增强；提高；n. 长枕；垫枕
endorse|v. 签署；背书；支持；赞同
supportive|adj. 支持的；支援的；给予帮助的
sustain|v. 支撑；承受；维持
sustainable|adj. 可以忍受的；可支撑的；可持续的
sympathetic|adj. 同情的
check|v. 检查；核实；克制；n. 检查；支票；方格图案
checker|n. 检验员；审核员；检验机；方格图案；v.  使呈现方格图案或不同颜色
check-in|n. 签到；登记处
check-out|n. 检验；付款处；结账
checklist|n. 清单；检查表；备忘录；目录册
checked|adj. 有格子的；有格子花纹的；v. 检查；“check”的过去式和过去分词
check-up|n. 检查；体格检查
examine|v. 检验；审查；调查
examiner|n. 考官；主考人；检查员
examination|n. 考试；检查；审查
inspect|v. 检查；视察
inspector|n. 检查员；巡视员；视察员
countless|adj. 无数的；多的；数不清的
fraught|adj. 充满（不愉快事物）的；焦虑的
innumerable|adj. 无数的；数不清的
majority|n. 大多数；大部分
quantitative|adj. 数量的；定量的
quantity|n. 量；数量；大量
redundant|adj. 多余的；过剩的；被裁减的
suffuse|v. 弥漫于；充满；扩散；布满
total|n. 总额；总计；v. 共计；总数达；adj. 总的；全部的
volume|n. 卷；册；体积；音量
dearth|n. 缺乏；不足
deficient|adj. 不足的；缺乏的；有缺陷的
inadequate|adj. 不充分的； 不足的；能力不足的
lacking|adj. 缺乏的；不足的；v. 缺乏；短缺；“lack”的现在分词
paucity|n. 不足；缺乏
rareness|n. 稀罕；珍奇；稀薄
scant|adj. 一丁点的；微小的；不足的；欠缺的
scarce|adj. 缺乏的；不足的；稀有的
skimpy|adj. 短小的；少量的；贫乏的；不足的；吝啬的
sole|n. 鞋底；脚掌；adj. 仅有的；唯一的
solitary|adj. 独自的；单独的；孤寂的
sparse|adj. 稀少的；稀疏的
sparsely|adv. 稀少地；稀疏地
sporadic|adj. 不定时发生的；时有时无的；零星的
sporadically|adv. 间断发生地；零星地
combine ... with ...|phrase. 结合
oppose|v. 反对；反抗
characteristic|adj. 典型的；特有的；n. 特点；特性
confidence|n. 信心；信任；秘密；私事
capable|adj. 有能力的
anxiety|n. 忧虑；焦虑；渴望
directory|n. 姓名地址录；目录；指南
aghast|adj. 惊骇的；吓呆的
appall|v. 使胆寒；使惊骇
appalling|adj. 骇人的；可怕的；质量极差的；v. 使胆寒；使惊骇；“appall”的现在分词
cowardly|adj. 怯懦的；胆小的；adv. 胆怯地
bold|adj. 大胆的；醒目的；粗体的；无畏的；莽撞的
cower|v. 畏缩；退缩；抖缩
recoil|v. 反冲；弹回；报应；退缩；n. 反冲力；弹回；畏缩
craven|adj. 懦弱的；毫无志气的；n. 怯懦者
creepy|adj. 令人毛骨悚然的；令人不寒而栗的
dread|v. 害怕；畏惧；n. 恐惧；畏惧
dreadful|adj. 可怕的；恐惧的；令人不快的
fear|v. 害怕；惧怕；n. 害怕；惧怕
flutter|v. 振翼；颤动；飘动；挥动；n. 鼓翼；飘扬；激动不安
formidable|adj. 可怕的；令人敬畏的；难以对付的
frightening|adj. 引起恐惧的；使惊恐的；骇人的；v. 使惊吓；使惊恐；“frighten”的现在分词
fright|n. 惊吓；恐怖；惊骇
horrify|v. 使恐怖；使震惊
horror|n. 恐惧
intimidate|v. 胁迫；威胁；恐吓
frighten|v. 使惊吓；使惊恐
menace|n. 威胁；恐吓；危险物；v. 威胁；恐吓
panic|n. 恐慌；惊恐；v. 使…惊慌；感到恐慌
petrified|adj. 吓呆的；惊呆的；目瞪口呆的；v. （使）石化；（使）僵化；吓呆；“petrify”的过去式和过去分词
petrify|v. 使石化；使僵化；吓呆
scare|n. 惊吓；惊恐；v. 惊吓；使害怕
terrified|adj. 恐惧的；受惊吓的；v. 使恐惧；使惊吓；“terrify”的过去式和过去分词
terrify|v. 使恐惧；使惊吓
terror|n. 恐怖；恐惧
terrorise|v. 恐吓；恫吓
threaten|v. 威胁；恐吓
timid|adj. 胆小的；羞怯的
timidity|n. 胆怯；胆小；羞怯
timidly|adv. 胆小地；羞怯地
tremble|v. 发抖；打颤；战栗；焦虑；n. 震颤；发抖；战栗；焦虑
trembling|n. 发抖；adj. 发抖的；v. 发抖；打颤；战栗；焦虑；“tremble”的现在分词
trepidation|n. 惊恐；惶恐；战栗
xenophobic|adj. 仇外的；排外的
ability|n. 能力；才能
capability|n. 能力；才能；性能
competence|n. 能力；胜任；本领
disposition|n. 性情；意向；处置
nature|n. 自然；本性
fortitude|n. 刚毅；坚忍
spunk|n. 勇气；胆量；决心
quality|n. 质量；素质；品质
resourceful|adj. 资源丰富的；机敏的；足智多谋的
skillful|adj. 有技巧的；熟练的；灵巧的
stamina|n. 精力；体力；耐力
endurance|n. 耐力；持久
talent|n. 才能；天才
temperament|n. 气质；性情；易激动；急躁
versatile|adj. 多才多艺的；有多种技能的；多方面的
many-sided|adj. 多方面的
talented|adj. 天赋高的；有才能的；有才干的
all-around|adj. 全面的
vigor|n. 精力；活力
radically|adv. 彻底地；根本地
extensive|adj. 广大的；广阔的；广泛的；大量的
complex|adj. 复杂的；费解的；n. 综合楼（群）；情结
simple|adj. 简单的；朴素的；单纯的
professional|adj. 专业的；职业的；n. 专业人士
dedicated|adj. 专注的；献身的；专用的；v. 奉献；献身；致力；“dedicate”的过去式和过去分词
staff|n. 职员；全体职工；棍棒；拐杖；v. 为…配备职员
personnel|n. 职员；全体人员；人事部
adviser|n. 顾问；提供意见者
adaptability|n. 适应能力
creative|adj. 有创造力的
decisive|adj. 决定性的；果断的
determination|n. 决心；坚定；测定
diligent|adj. 勤勉的；勤奋的
discretion|n. 谨慎；慎重；自行决定
extroversive|adj. 外向的；外翻的
innovative|adj. 革新的；新颖的；富有革新精神的
leadership|n. 领导才能；领导地位
mastermind|v. 策划；n. 决策者；出谋划策者
obliged|adj. 感激的；感谢的；v. 迫使；责成；施惠；“oblige”的过去式和过去分词
problem-solving|n. 解决问题
prudential|adj. 谨慎的；细心的；深谋远虑的
teamwork|n. 团队合作；协同工作
commitment|n. 承诺；奉献
dedication|n. 献身；奉献；献词
devote|v. 投入；献身
devotion|n. 献身；热爱；奉献
buyer|n. 买方；采购员
CEO|abbr. 执行总裁；首席执行长官；“Chief Executive Officer”的缩写
Chief Executive Officer|n. 首席执行官
controller|n. 管理者；控制者；控制器；财务总管
GM|abbr. 总经理；“General Manager”的缩写
General Manager|n. 总经理
manager|n. 经理；管理者
seniority|n. 资历；年长；级别高
subordinate|adj. 次要的；附属的；n. 下属；从属物；v. 使居于次要
subordination|n. 放置在次级；次级；附属
supervisory|adj. 管理的；监控的
appoint|v. 任命；委派；约定；指定
audition|n. 试听；试唱；试演；听力；v. 试听；试音；试镜；让…试演
career advisor|phrase. 职业顾问
career objective|phrase. 职业目标；求职目标
career|n. 事业；生涯
chore|n. 家务活；杂事；令人讨厌的或繁重的工作
dismiss|v. 解雇；解散；摒除；不理会；（法律）驳回
dismissive|adj. 轻蔑的；鄙视的
dismissal|n. 解雇；开除；免职
draft|n. 草稿；v. 起草；草拟
drudgery|n. 单调乏味的苦差事
get fired|phrase. 被解雇；炒鱿鱼
hand over|phrase. 交出； 交付
hectic|adj. 紧张忙碌的；忙乱的
busy|adj. 忙碌的；忙于
internship|n. 实习；见习
log|n. 原木；木头；航海日志；v. 伐木；（正式地）记载
name plate|phrase. 铭牌；商标
occupation|n. 占领；占有；职业；消遣
officeholder|n. 公务员
officially|adv. 正式地；官方地
overtime|n. 超时；加班；加班费；v. 使超时；adv. 超时地
part-time job|phrase. 兼职工作
position sought|phrase. 谋求的职位
profession|n. 职业；专业
quit office|phrase. 离职；辞职
quit|v. 停止；辞职； 离开
relevant document|phrase. 相关文件
resign|v. 辞职；使…顺从于（做）某事
resignation letter|phrase. 辞职信
sketch|n. 草图；素描；概述；v. 草拟；速写；简述
undertaking|n. 事业；企业；承诺；保证；v. 承担；从事；保证；“undertake”的现在分词
vocation|n. 职业；行业；使命
summarise|v. 总结；摘要；概述
generalize|v. 概括；归纳；泛论；推广
statement|n. 声明；陈述
grammarian|n. 语法专家；文法家；语言学专家
describe|v. 描述
description|n. 描述；形容
prescribe|v. 开药方；规定
variation|n. 变化；变动
halt|n. 停顿下来；v. 暂停；中断
affix|v. 附加；粘贴；署名；n. 附加物；词Ð
antonym|n. 反义词
auxiliary verb|phrase. 助动词
bilingualism|n. 双语
code-switching|phrase. 代码转换
coinage|n. 造币；货币；货币制度；新造的词语
cultural background|phrase. 文化背景
cultural identity|phrase. 文化认同；文化身份；文化特性
cultural conflict|phrase. 文化冲突
dialect|n. 方言；地方话
dialectal variation|phrase. 方言变异
dominant language|phrase. 主导语言
Indo-European language|phrase. 印欧语
intonation|n. 语调；声调；音准
Latin|n. 拉丁语；adj. 拉丁语的；拉丁语系国家的
multilingual|adj. 使用多种语言的；说多种语言的
paraphrase|v. 意译；解释；改述；n. 释义；意译；改述
prefix|n. 前Ð；v. 在…前面加
Sanskrit|n. 梵语
suffix|n. 后Ð；词尾
synonym|n. 同义词
accentuate|v. 重读；强调；突出
accentuation|n. 重读；强调
clarification|n. 澄清；阐明；净化
convey|v. 传达；表达；运送；输送
delineate|v. 描画；划定（边界）
depict|v. 描述；描绘
represent|v. 代表；表现；体现；相当于
picture|n. 图画；照片；v. 想象；描述
elucidate|v. 阐明；说明
emphasize|v. 强调；着重
emphatic|adj. 强调的；明确表示的；加强语气的
emphasis|n. 强调；重点
enunciate|v. （清楚地）发音；清楚地表明；阐明
exemplify|v. 举例说明；例证；例示
exposition|n. 博览会；展览会；阐述
expound|v. 详细说明；阐述
highlight|n. ¸突出的部分；v. 突出；强调
illuminate|v. 照亮；阐明；解释
insinuate|v. 暗示；迂回
interpretation|n. 解释；口译
explanation|n. 解释；说明；阐述
narrate|v. 叙述；给（电视或电影）作旁白
reiterate|v. 反复地说；重申；重述
specify|v. 详细说明；指定；阐述
stress|n. 压力；紧张；强调；重音；v. 着重；强调
underline|v. 在…下面划线；强调
interdisciplinary|adj. 各学科间的；跨学科的
contradictory|adj. 矛盾的；反驳的；抗辩的；n. 对立物；矛盾因素
clack|v. 发出哒哒声；n. 哒哒声
heel|n. 足跟；脚后跟
pavement|n. 路面；人行道
hiss|v. 发嘶嘶声；发嘘声；n. 嘶嘶声；嘘声
intrusive|adj. 侵入的；打搅的；闯入的
relax|v. 放松；松懈
bark|v. 狗吠；咆哮；厉声说；n. 犬吠声；树皮
brittle|adj. 硬但易碎的；脆弱的；尖利的
brittleness|n. 脆性；易碎
chink|n. 裂缝；叮铛声；v. 叮当响
clash|n. 碰撞；撞击声；冲突；v. 发出（金属）撞击声；猛撞；冲突
click|v. 发出咔哒声；点击；n. 咔哒声；点击
crack|n. 裂缝；裂纹；噼啪声；v. 断裂；破裂；打击；使崩溃
crash|v. 碰撞；坠毁；崩溃；n. 碰撞；坠毁；崩溃
scream|n. 尖锐刺耳的声音；v. 尖叫；呐喊
hum|n. 嗡嗡声；v. 嗡嗡叫；哼
snap|v. 突然断裂；劈啪作响；猛然咬；快速地说；拍照；n. 啪嗒声；快照；adj. 突然的；匆忙的；adv. 劈啪作响地
stroke|n. 一击；打击；中风； 轻抚；划水动作；钟鸣；v. 轻抚
strike|v. 击打；罢工；侵袭；突然想到；划（火柴）；n. 罢工；袭击
thunder|n. 雷；雷声；v. 打雷；雷鸣；怒吼
thunderstorm|n. 雷雨；雷暴雨
thundercloud|n. 雷雨云
whisper|v. 耳语；低语；n. 耳语；低语；飒飒的声音
whistle|v. 吹口哨；鸣汽笛；n. 口哨声；汽笛声
infringe|v. 侵犯；违反；侵害
interfere|v. 干涉；干预；干扰
interference|n. 干扰；干涉；妨碍
interpose|v. 置于…之间；插入；插嘴；介入
intervene|v. 干涉；介入；打岔；干扰
obstacle|n. 障碍
animate|adj. 有生命的；有活力的；v. 使具活力；做成动画
bouncing|adj. 健壮的；精神饱满的；v. 弹跳；反弹；“bounce”的现在分词
frisky|adj. 欢跃的；活泼的
frolicsome|adj. 嬉闹的；爱闹着玩的
playful|adj. 顽皮的；爱玩耍的；嬉戏的
vibrant|adj. 振动的；有活力的；明快的
vivacious|adj. 活泼的；有生气的
contradict|v. 反驳；相矛盾
contradiction|n. 矛盾；不一致；反驳
discord|n. 不一致；不和；纷争
friction|n. 摩擦；不和；争执
acoustician|n. 声学家
acoustics technology|phrase. 声学技术
audible|adj. 听得见的
audio|adj. 音频的；声音的
auditory|adj. 听的；听觉的
echo|n. 回声；v. 回响
harmonic|n. 和声；谐波；adj. 调和的；和声的
hydrophone|n. 水听器
infrasound|n. 次声
mechanical wave|phrase. 机械波
rarefaction|n. 稀疏；疏松
rarefy|v. 使稀薄；稀释；精炼
resonate|v. 共鸣；共振
reverberation|n. 回响；反射
reverberate|v. 回响；反响；回荡
sonar|n. 声纳
sonic|adj. 声波的；声音的
sound waves|phrase. 声波
supersonic|adj. 超音速的
ultrasonic frequency|phrase. 超声频率
ultrasound|n. 超声波
vocalization|n. 发声；嗓音；说出的话
wave motion|phrase. 波动
pagoda|n. 塔；宝塔
taper|n. 细蜡烛；灯芯；渐减；逐渐尖细；v. 逐渐变细；逐渐减少
floor plan|phrase. 平面图
weight|n. 重量；砝码；秤锤；重物；负担；重要性；v. 使负担；装载过重；视…为重要
corresponding|adj. 符合的；相应的；v. 符合；通信；“correspond”的现在分词
pillar|n. 柱子；栋梁
aisle|n. 过道；通道；走廊
walkway|n. 走道；人行道
amphitheatre|n. 阶梯教室
architect|n. 建筑师；设计者；创造者
architectural|adj. 建筑学的；建筑方面的
architecture|n. 体系结构；建筑学；建筑设计
archway|n. 拱道；拱门
background wall|phrase. 背景墙
bay window|phrase. 飘窗
building technique|phrase. 建筑技术
ceiling|n. 天花板
chamber|n. 房间；室；腔；大会议室；议院
circus|n. 马戏团
civil engineering|phrase. 土木工程
colonnade|n. 柱廊
decorate|v. 装饰；装修
decorative|adj. 装饰性的；作装饰用的
ornamental|adj. 装饰性的；点Ð的；n. 观赏植物；装饰物
dome|n. 穹顶；圆屋顶
downcomer|n. 下水管
draftsman|n. 绘图员；制图员；起草员
elevation|n. 提升；海拔；高地；立面图
elevate|v. 举起；提高；提升；振奋
lay the foundation|phrase. 奠定基础；打地基
ledge|n. 架状突出物；壁架；暗礁
lintel|n. 过梁
log structure|phrase. 木结构
metal frame|phrase. 金属框架
monumental architecture|phrase. 纪念碑建筑
ornament|n. 装饰；装饰品；v. 装饰；美化
plane graph|phrase. 平面图
rebuild|v. 重建；重新组建
reconstruction|n. 重建；重新修建
residential|adj. 住所的
restructure|v. 重建；重构
roof|n. 屋顶；顶部；v. 给…盖顶
structural|adj. 结构（或构造）上的
subtle design|phrase. 精致的设计
vault|n. 拱顶；墓穴；金库；撑竿跳；v. 跳跃
vaulted|adj. 拱形的；有拱顶的；v. 跳跃；“vault”的过去式和过去分词
wing|n. 翅膀；翼
brick|n. 砖；砖块
cement|n. 水泥；胶合剂；黏固粉；v. 用水泥涂；粘牢；巩固
composite board|phrase. 复合板
granite|n. 花岗岩
marble|n. 大理石；弹珠；理智；adj. 大理石的
monolith|n. 独块巨石；独石碑
mortar|n. 臼；研钵；灰浆；迫击炮
plaster|n. 灰泥；膏药；熟石膏；v. 涂以灰泥；敷以膏药
plasterboard|phrase. 石膏板
slate|n. 板岩；石板瓦；候选人名单；v. 铺石板；预定；安排；严厉批评；adj. 板岩色的；深蓝灰色的
wood|n. 木材；木头；树林
baroque|adj. 巴洛克式的；奇形怪状的；n. 巴洛克式；怪异型
byzantine|adj. 拜占庭风格的；错综复杂的
classical architecture|phrase. 古典建筑
rococo|adj. 洛可可式的；旧式的；过分修饰的；n. 洛可可式
Romanesque architecture|phrase. 浪漫建筑
accident|n. 意外；事故；意外事件
occur|v. 发生；出现
occurrence|n. 发生的事；发生
federal|adj. 联邦的；联邦制的；联邦政府的
aviation|n. 航空；航空学；飞行（术）
administration|n. 管理；行政
oversee|v. 监督；监视
aircraft|n. 航空器；飞行器
congested|adj. 拥挤的；堵塞的；v. 充满；拥挤；“congest” 的过去式和过去分词
congestion|n. 堵塞；充塞；充血；淤血
astronaut|n. 宇航员；太空人
spaceman|n. 太空人；宇航员
embark|v. （使）上船或飞机；（使）从事
enroute|n. 在途中
microwave|n. 微波；微波炉；v. 用微波炉加热
navigation|n. 导航；航行；航海
navigation monitor|phrase. 航行检测仪
observatory|n. 天文台；气象台
satellite communication|phrase. 卫星通信
shuttle|n. 梭子；穿梭；往返移动之物；航天飞机；v. 穿梭移动；往返运送
spaceship|n. 宇宙飞船；太空船
telescope|n. 望远镜
veer|v. 改变方向；转向；n. 转向
block up|phrase. 封锁
detour|n. 迂回路；绕道；v. 绕路而行
devious|adj. 不直接的；不正直的；迂回的
deviousness|n. 迂回；曲折
GPS|abbr. 全球定位系统；“Global Position System”的缩写
jostle|v. 挤；推；撞；争夺；n. 挤拥；推撞
muddy|adj. 泥泞的；模糊不清的；v. 使沾上泥；弄糊涂
orderly|adj. 有秩序的；整齐的
overcrowd|v. 使（过分）拥挤；挤满
overcrowded|adj. 挤满的；过度拥挤的
overspeed|n. 超速；adj.. 超速的；v. (使)超速运行
roundabout way|phrase. 绕路
slippery|adj. 滑的；狡猾的
smoothly|adv. 顺利地；平稳地；顺畅地
smooth|adj. 平坦的；平滑的；v. 使平坦；使平滑
traffic control|phrase. 交通管理
traffic jam|phrase. 交通堵塞
administrative|adj. 管理的；行政的
allege|v. 宣称；断言；声称
alleged|adj. 声称的；被断言的；所谓的；被指称的；涉嫌的；v. 宣称；断言；声称；“allege”的过去式和过去分词
charter|n. 宪章；许可证；包租；v. 包租（汽车、飞机等）；特许
enact|v. 制定（法律）；通过（法律）；扮演（角色）
enactment|n. 制定；通过；上演
governance|n. 治理；管理方法；统治方式
macro-control|n. 宏观调控
mandate|n. 授权；任期；委任；命令；v. 授权；委任
plenary|adj. 全体参加的；无限的；完全的；n. 全会；全体会议
pragmatic|adj. 务实的；实事求是的；实用主义的
prohibit|v. 禁止；妨碍
prohibition|n. 禁止；禁令；诉讼中止令
safeguard|n. 保护措施；v. 保卫；保护
social security|phrase. 社会保障；社会保险
supervise|v. 监督；管理；指导
viable|adj. 可行的；可实施的
tourist|n. 旅游者；观光者
flock|n. 群；v. 聚集；群集
far-flung|adj. 分布广的；范围广的；遥远的
gaze|v. 凝视；注视；n. 凝视；注视
marvel|n. 奇异的事物；令人惊异的人（或事）；v. 惊异于；惊异
marvelous|adj. 极好的；绝妙的；令人惊异的
reminder|n. 提醒人的事物；通知单；提示信
ingenuity|n. 独创力；聪明才智
artistry|n. 艺术性；艺术修养；艺术才能；技艺
ancestral hall|phrase. 宗祠；祠堂
ancestral temple|phrase. 祖庙；宗祠
ancient architecture|phrase. 古代建筑
ancient bridge|phrase. 古桥
ancient dwelling|phrase. 古民居
ancient water infrastructure|phrase. 古代水利基础设施
bridge|n. 桥；桥梁
castle|n. 城堡
catacomb|n. 地下墓穴
Chinese ancient academy|phrase. 中国古代书院
city defense project|phrase. 城市防御工程
classical garden|phrase. 古典园林
ecclesiastical building|phrase. 宗教建筑
folk custom|phrase. 民间习俗
Great Wall|n. 长城
memorial hall|phrase. 纪念堂；纪念馆
military defense project|phrase. 军事防御项目
mosque|n. 清真寺
museum|n. 博物馆
national custom|phrase. 国家风俗；民族风俗
palace|n. 宫殿；王宫
pavilion|n. 大帐蓬；亭；阁；看台；馆；v. 搭帐蓬
religious activity|phrase. 宗教活动
religious art|phrase. 宗教艺术
temple|n. 庙宇；太阳穴
Temple of Heaven|n. 天坛
Temple of Emperor Qin Shihuang|n. 秦始皇庙
astound|v. 使震惊；使大惊
surprise|v. 使惊奇；使感到意外；n. 惊讶；惊喜；意外
astonish|v. 使惊讶
breathtaking|adj. 惊人的；激动人心的；惊险的
exciting|adj. 令人激动的；使人兴奋的；v. 使兴奋；使激动； “excite”的现在分词
dismay|n. （因惊愕）沮丧；失望；v. 使惊愕、沮丧
dumbfound|v. 使说不出话来；使目瞪口呆
fabulous|adj. 难以置信的；寓言般的；极巨大的；极好的
inconceivable|adj. 难以想象的；难以相信的
unthinkable|adj. 难以想象的；不可思议的；难以置信的
unbelievable|adj. 难以相信的；难以置信的
overwhelm|v. 使不知所措；使无法解决；击败；压垮；淹没
stupefy|v. 使惊呆；使惊愕；使神志不清
startle|v. （使）惊动；（使）惊愕；（使）吃惊
amaze|v. 使惊奇；使吃惊
striking|adj. 引人注目的；显著的；v. 打击；罢工；“strike”的现在分词
antiseptic|adj. 防腐的；抗菌的；n. 杀菌剂；防腐剂；消毒剂
property|n. 所有物；财产；属性；性质
tannin|n. 丹宁酸；鞣酸
hop|v. 单腿跳；跳跃；齐足跳；跃过；n. 跳跃；蹦跳；啤酒花
flourish|v. 茁壮成长；繁荣兴旺；挥动；n. 夸张动作
succumb|v. 屈服；屈从
waterborne|adj. 水运的；由饮用水传染的
dysentery|n. 痢疾
black tea|n. 红茶
chamomile tea|phrase. 菊花茶；甘菊茶
cocoa|n. 可可粉；可可饮料
coconut milk|phrase. 椰汁
coconut water|phrase. 椰子汁
diet cola|phrase. 低热量的可乐；不含糖的可乐
energy drink|phrase. 能量饮料；功能饮料
grapefruit flavor|phrase. 葡萄柚香精
green tea|phrase. 绿茶
ice water|phrase. 冰水
iced tea|phrase. 冰茶
jasmine tea|n. 茉莉花茶
lemon flavor|phrase. 柠檬香精
lemon tea|phrase. 柠檬茶
lemonade|n. 柠檬汽水；柠檬饮料
lime flavor|phrase. 白柠檬香精
loose leaf|phrase. 活页；散装
milk tea|phrase. 奶茶
mineral water|phrase. 矿泉水
orange juice|phrase. 橙汁
purified water|phrase. 纯净水
room temperature water|phrase. 常温水
soda water|phrase. 苏打水；汽水
soda|n. 苏打；苏打水
sparkling water|phrase. 苏打水
sports drink|phrase. 运动型饮料
spring water|phrase. 泉水
still water|phrase. 静水
tea bag|phrase. 茶叶袋；茶包
tomato juice|phrase. 番茄汁
vegetable juice|phrase. 蔬菜汁
vitamin water|phrase. 维他命水
boom|n. 繁荣；景气；v. 发出隆隆声；快速发展；暴涨
business boom|phrase. 商业繁荣
economic development|phrase. 经济发展
outpace|v. 跑得比…快；超过
acute|adj. 敏锐的；灵敏的；急性的；严重的；成锐角的
catching|v. 捕捉；“catch”的现在分词；adj. 有传染性的
contagious|adj. 传染性的；有感染力的
fester|v. 化脓；溃烂；腐烂；恶化
feverish|adj. 发烧的；紧张忙乱的；极度紧张（或兴奋）的
incubation period|n. 潜伏期
infect|v. 传染；感染
infectious|adj. 传染性的；有感染力的
morbid|adj. 病态的；心理不健康的
compact|adj. 紧密的；小型的；n. 协定；小型汽车；化妆粉盒
crisp|adj. 脆的；脆嫩的
crooked|adj. 弯曲的；扭曲的；欺诈的；不老实的；v. （使）弯曲；使成钩状；“crook”的过去式和过去分词
twisted|adj. 扭曲的；v. 捻；搓；拧；扭转；曲折；“twist”的过去式和过去分词
curved|adj. 呈弯曲状的；弧形的；v. （使）弯成弧形；“curve”的过去式和过去分词
bent|adj. 弯曲的；决意的；n. 倾向；爱好；v. 弯曲；使弯曲；屈服；“bend”的过去式和过去分词
dense|adj. 密集的；稠密的；愚钝的
ethereal|adj. 轻飘的；缥缈的；虚空的；精致的
impervious|adj. 不能渗透的；不受影响的
lithe|adj. 易弯的；柔软的；动作轻盈的
ponderous|adj. 沉重的；笨重的；沉闷的
portable|adj. 便携式的；手提的；n. 便携式打字机
slim|adj. 苗条的；纤细的；微小的
willowy|adj. 修长苗条的；柳树成荫的
slick|adj. 光滑的；圆滑的；熟练的；华而不实的；n. 浮油层；光滑之处；v. 使平滑
sloppy|adj. 邋遢的；随便的；草率的；马虎的；泥泞的；宽松肥大的；多阴雨的；感情脆弱的
supple|adj. 柔软的；灵活的；思维敏捷的
tenuous|adj. 脆弱的；稀薄的；空洞的
recently|adv. ¸近；近来
engineer|n. 工程师；机械师；v. 设计（工程）；策划
major|adj. 主要的；较多的；成年的；大调的；n. 主修课；成年人；少校；大调；v. 主修
breakthrough|n. 突破；突破性进展
so-called|adj. 所谓的
code|n. 代码；密码；编码；行为准则；法典；法规；v. 编码
come close to|phrase. 接近；几乎
ultimate|adj. ¸后的；¸终的；¸基本的；极端的；n. ¸终
ultimately|adv. ¸终；归根结底；根本上
maximum|n. ¸大限度；¸大量；adj. ¸多的；¸大极限的
transmit|v. 发送；传播；传递
reliably|adv. 可靠地
play a role in|phrase. 在...扮演一个角色；起作用
videophone|n. 可视电话
revolution|n. 革命
contrive|v. 图谋；发明；设计；设法做到
plan|n. 计划；打算；v. 计划；打算
criterion|n. 标准；准则；规范
devise|v. 想出；设计；发明
invent|v. 发明；创造
dissect|v. 解剖；剖析；仔细分析
expertise|n. 专门技能；专门知识
gauge|n. 测量仪器；规格；计量器；评估；v. 测量；评估
android|n. 机器人；安卓系统
app store|phrase. 应用商店
app|n. 计算机应用程序
bar phone|phrase. 直板手机
battery|n. 电池；一组；一连串
bluetooth headset|phrase. 蓝牙耳机
charger|n. 充电器；军马；战马
digital camera|phrase. 数码相机
digital video camera|phrase. 数码相机
download|n. 下载；v. 下载
GPS navigation unit|phrase. GPS导航装置
iCloud|n. 云存储
iOS|phrase. 苹果移动设备操作系统
iTunes|n. 苹果公司的一款数字媒体播放应用程序
low battery|phrase. 低电量
media player|phrase. 媒体播放器
mobile banking|phrase. 手机银行
mobile broadband|phrase. 移动宽带
mobile payment|phrase. 移动支付；用手机进行支付
motion sensor|phrase. 运动传感器·
operating system|phrase. 操作系统
PDA|abbr. 掌上电脑；个人数字助理；“personal digital assistant”的缩写
personal digital assistant|n. 个人数字助理；掌上电脑
pocket-sized|adj. 袖珍的；便携的
portable power source|phrase. 便携式移动电源
power off|phrase. 关机；关掉
program crash|phrase. 程序故障；程序崩溃
resolution|n. 决心；坚决；决议；解决；分辨率
retina|n. 视网膜
ringtone|n. 铃声
roaming|n. （手机）漫游；v. 漫步；“roam”的现在分词
screen protector|phrase. 屏幕保护膜
selfie stick|phrase. 自拍杆
slide phone|phrase. 滑盖手机
smart phone|phrase. 智能手机
touch screen|phrase. 触摸屏
user interface|phrase. 用户界面
video games|phrase. 电子游戏
genetically|adv. 遗传上地；基因上地
logically|adv. 逻辑上；合乎逻辑地
measure|n. 衡量；量度；措施；方法；v. 测量；衡量；度量
fixed|adj. 固定的；不能变的；不易改变的；v. 修理；固定；确定；“fix”的过去式和过去分词
programme|n. 节目；计划；程序；v. 安排；计划；编程
clutch|v. 抓住；攫住；n. 紧抓；离合器；一窝雏；一小群；紧要关头
curb|v. 勒住；抑制；n. 抑制；约束；路缘；勒马绳
manipulate|v. 操纵；使用
mastery|n. 控制；熟练掌握；驾驭
emigration|n. 移民；移居外国
expectation of life|phrase. 寿命
general mortality rate|phrase. 总体死亡率
immigration|n. 移民；移居
infant mortality rate|phrase. 婴儿死亡率
internal migration|phrase. 内部迁移
migrant|n. 移居者；候鸟；adj. 迁移的；迁徙的；移栖的
migration rate|phrase. 迁移率
NPG|abbr. 人口负增长（negative population growth）
negative population growth|phrase. 人口负增长
random sampling|phrase. 随机抽样
vital statistics|phrase. 生命统计；女子三围尺寸
ZPG|abbr. 人口零增长
zero population growth|phrase. 人口零增长
annuity|n. 年金；养老金；年金保险
desolate|adj. 荒凉的；孤寂凄凉的；v. 使荒无人烟；使孤寂凄凉
deserted|adj. 废弃的；荒芜的；被遗弃的；v. 遗弃；离弃；“desert”的过去式和过去分词
dink|n. 吊球；abbr. 丁克
Double Income No Kids|n. 丁克家族
disease prevention|phrase. 疾病预防
elder|adj. 年龄较大的；年长的；n. 长者；长辈
fertility level|phrase. 生育水平；土壤肥力水平
longevity|n. 长寿；寿命
longevous|adj. 长寿的
medical level|phrase. 医疗水平
nursing home|phrase. 私人疗养院
pension|n. 养老金；退休金；抚恤金
old-age pension|phrase. 退休金；养老金
professional care|phrase. 专业护理
progeny|n. 后代；后裔；子孙
workforce shortage|phrase. 劳动力短缺
debate|v. 辩论；争论；n. 辩论；争论
challenge|n. 挑战；盘问；质疑；怀疑；v. 提出挑战；质疑；驳斥
underlying|adj. 在下面的；根本的；潜在的；v. 为…的起因；构成…的基础；“underlie”的现在分词
ensure|v. 确保；保证；担保
identify ... with ...|phrase. 与......有同感；认为......紧密相关
identifiable|adj. 可识别的；可辨认的
recognize|v. 认出；意识到；承认
dependency|n. 依赖；附属国；附属地
unsupportive|adj. 无人支持的
agricultural|adj. 农业的
agrochemical|n. 农用化学品
barren|adj. 贫瘠的；不结果实的；不孕的；无价值的
barn|n. 谷仓；牲口棚
by-product|n. 副产品；意外结果
compost|n. 堆肥；混合肥料；v. 把…制成堆肥；施堆肥于
fallow|adj. 犁过而未耕种的；休耕的；休闲中的；n. 休耕的田地；闲置；休整；v. 使（翻耕后的土地）休闲
farm machine|phrase. 农业机械
fecund|adj. 多产的；肥沃的；丰饶的
harvest|n. 收获；收成；v. 收割；收获
irrigation|n. 灌溉；冲洗
muck|n. 污物；粪肥；淤泥；v. 施肥；弄脏
plant|n. 植物；作物；车间；装置；工厂；发电厂；v. 种植；栽培；安置；放置
planting|n. 种植；栽种；v. 种植；“plant”的现在分词
pump|n. 泵；抽水机；打气机；v. 抽水；打气
reap|v. 收割；收获；获得
reaper|n. 收割者；收获者；收割机
throughput|n. 工作量；生产量；吞吐量
warehouse|n. 仓库；货栈；v. 把…存入仓库
yield|v. 生产；获利；屈服；让步；n. 产量；利润
resolve|v. 决心要；解决；（使）分解；n. 决心
soluble|adj. 可溶的；可解决的；可解答的
resoluble|adj. 可分解的；可溶解的
unsolvable|adj. 无法解决的；无法溶解的
solve|v. 解决；解答
assure|v. 保证
solidify|v. 变凝固；变结实；使坚强巩固
cash crop|phrase. 经济作物
grain crop|phrase. 谷类作物
grass crop|phrase. 饲料作物
green manure crop|phrase. 绿肥作物
horticultural crop|phrase. 园艺作物
medicinal plant|phrase. 药用植物
ornamental plant|phrase. 观赏植物
vegetable crop|phrase. 蔬菜作物
interdependent|adj. 互相依赖的；相倚的
recourse|n. 依靠；求援；诉诸
reliance|n. 依赖；依靠；信任
distrust|n. 怀疑；不信任；v. 怀疑；不信任
rely|v. 依靠；信赖
laboratory|n. 实验室
trial|n. 审判；试验；考验；v. 测试
experiment|n. 实验；试验；v. 做试验；进行实验
test|v. 试验；测试；n. 试验；测验
neutralise|v. 使中立；中和；使无效
equip|v. 装备；配备
armoury|n. 军械库；兵工厂
laser|n. 激光
discharge|v. 放出；排出；开除；偿还债务；履行；卸货；放电；n. 排放；排放出的物体
lightning|n. 闪电
emit|v. 发出；发射
exhale|v. 呼出；散发
release|n. 释放；发布；v. 释放；发布
smell|n. 闻；气味；嗅觉；v. 嗅；闻；散发气味；察觉
annotation|n. 注解；注释；评注
collect data|phrase. 收集数据
control group|phrase. 对照组
experimental|adj. 以实验为基础的；实验性的
finding|n. 裁决；调查发现；v. 找到；发现；“find”的现在分词
interpret|v. 口译；把…理解为；解释
lab|n. 实验室；研究室
lab report|phrase. 实验室报告
model|n. 模型；模特儿；模范；型号；v. 将…做成模型；当模特儿
null|adj. 等于零的；无效的；无价值的
research|n. 研究；探索；调查；v. 研究；调查；探讨
research result|phrase. 研究结果
revision|n. 修订；修改；复习
revise|v. 修正；温习；校订
simulation|n. 模拟；仿真
treatment group|phrase. 治疗组
alternative energy|phrase. 替代能源
clean energy|phrase. 清洁能源
electric|adj. 电的；用电的
fuel|n. 燃料；燃油；刺激因素；v. 加燃料；加剧
gas|n. 气体；气态；汽油；天然气；煤气
new energy|phrase. 新能源
nuclear energy|phrase. 核能
ore|n. 矿石
petrol|n. 汽油
petroleum|n. 石油
resource|n. 资源；物力；财力；智谋；才略
resourcefulness|n. 智谋；足智多谋
solar energy|phrase. 太阳能
tidal energy|phrase. 潮汐能
white coal|phrase. 发电用水
wind energy|phrase. 风能
wind power generation|phrase. 风力发电
eliminate|v. 消除；排除；淘汰
secrecy|n. 秘密；保密；隐蔽
openly|adv. 公开地；毫不隐瞒地；坦率地
communicate|v. 沟通；交流
remuneration|n. 报酬；酬金
publicise|v. 宣传；公布
bonus|n. 奖金；红利；额外津贴
annual|adj. 每年的；一年一次的；n. 年刊；年鉴
lump|n. 块；肿块；隆起；v. 混在一起；结块；勉强接受
sum|n. 总数；算术；金额；v. 概括
spread out|phrase. 展开；摊开
added|adj.  附加的；增加的；更多的；v. 加；增加；“add”的过去式和过去分词
allowance|n. 零用钱；津贴
base on|phrase. 基于；以…为根据
basic wage|phrase. 基础工资；基本工资
daily wage|phrase. 日薪
day-off|n. 休息日
flexible time|phrase. 弹性时间；灵活的时间
give a raise|phrase. 加薪
hourly wage|phrase. 每小时工资
income|n. 收入；收益；所得
longevity pay|phrase. 工龄补贴
merit pay|phrase. 功绩酬劳；绩效工资
perquisite|n. 额外补贴；特权
visible|adj. 看得见的
potentially|adv. 潜在地
motivating|v. 激发；激励；“motivate”的现在分词
plus|prep. 加；加上；conj. 加；和；并且；adj. 正的；加的；超过的；n. 加号；正数；优势
post wage|phrase. 岗位工资
premium|n. 保险费；奖金；额外费用；溢价；adj. 高价的；优质的
probation|n. 缓刑；试用期
probationary period|phrase. 试用期；见习期
reasonable request|phrase. 合理的要求
salary man|phrase. 工薪人员
salary range|phrase. 工资范围；薪资范围
seniority pay|phrase. 资历薪酬
starting salary|phrase. 起薪
subsidy|n. 补贴；津贴；补助金
title allowance|phrase. 职称津贴
wage|n. 工资；v. 发动
encourage|v. 鼓励；鼓舞；促进；鼓动
encouragement|n. 鼓励；鼓舞
hearten|v. 鼓励；振奋；激励
incentive|n. 刺激；诱因；动机
inspire|v. 鼓舞；激励；启迪；激起；促成
inspired|adj. 有灵感的；有创造力的；授意的；v. 鼓舞；激励；“inspire”的过去式和过去分词
inspiring|adj. 鼓舞的；激励的；v. 鼓舞；激励；“inspire”的现在分词