atmosphere|n. 大气；气氛；氛围
hydrosphere|n. 水圈
lithosphere|n. 岩石圈
oxygen|n. 氧；氧气
oxide|n. 氧化物
carbon dioxide|phrase. 二氧化碳
hydrogen|n. 氢
core|n. 核；核心；重点；v. 去（果）核
crust|n. 外壳；硬壳；面包皮；地壳
mantle|n. 披风；斗篷； 覆盖物；地幔；v. 覆盖；遮盖
longitude|n. 经度
latitude|n. 纬度；行动或言论的程度
horizon|n. 地平线；（思想等的）范围；眼界
altitude|n. 海拔；高度
disaster|n. 灾害；灾难
mishap|n. 不幸之事；灾祸；恶运
catastrophic|adj. 灾难性的
calamity|n. 大灾祸；灾难
endanger|v. 使遭危险或伤害；危害；危及
jeopardise|v. 危及；使受危险
destructive|adj. 破坏的；毁灭性的
El Niño|n. 厄尔尼诺现象
greenhouse|n. 温室；玻璃暖房
phenomenon|n. 现象；杰出的人（pl. phenomena）
pebble|n. 鹅卵石；小圆石
magnet|n. 磁体；磁铁
ore|n. 矿石
mineral|n. 矿物；矿物质
marble|n. 大理石；弹珠；理智；adj. 大理石的
quartz|n. 石英
granite|n. 花岗岩
gust|n. 一阵狂风；突然的一阵；v. （风）猛刮
breeze|n. 微风；和风
monsoon|n. 季风；雨季
gale|n. 大风；一阵（喧闹）
hurricane|n. 飓风
tornado|n. 龙卷风；旋风
typhoon|n. 台风
volcano|n. 火山
erupt|v. 爆发；喷发
magma|n. 岩浆
thermodynamic|adj. 热力学的
smog|n. 烟雾
fume|n. 烟雾；烟气；愤怒；烦恼；v. 用烟熏；冒烟；大为生气
mist|n. 薄雾；朦胧不清
tsunami|n. 海啸
drought|n. 旱灾；干旱
flooding|n. 洪水泛滥；v. 淹没；泛滥；“flood”的现在分词
torrent|n. 急流；激流；湍流；一连串
earthquake|n. 地震
seismic|adj. 地震的
avalanche|n. 雪崩；纷至沓来
terrain|n. 地形；地势；地带
landscape|n. 景色；风景画
continent|n. 洲；大陆
cave|n. 洞穴
cliff|n. 悬崖；峭壁
glacier|n. 冰川；冰河
swamp|n. 沼泽；湿地；v. 淹没
delta|n. 三角洲；希腊语第四个字母（Δ、δ）
plain|n. 平原；adj. 简单明了的；朴素的
plateau|n. 高原；平稳期
oasis|n. （沙漠中的）绿洲；舒适的地方；乐土；乐事
globe|n. 球体；地球
hemisphere|n. 半球体；半个球
equator|n. 赤道
arctic|adj. 北极的；极寒的
Antarctic|adj. 南极的；n. 南极地区
pole|n. 柱；杆；地极
polar|adj. 极地的；两极的；对立的
axis|n. 轴；轴线
deteriorate|v. 恶化；变坏；退化
aggravate|v. 加剧；使恶化；激怒
degrade|v. 降级；降格；退化；降低…身份；使丢脸
upgrade|v. 提升；提高；改进；n. 向上的斜坡；增加；改进
erode|v. 侵蚀；腐蚀；逐渐丧失；削弱
Mediterranean|n. 地中海；adj. 地中海的
Atlantic|adj. 大西洋的；n. 大西洋
pacific|adj. 求和的；和平的；和解的
ocean|n. 海洋；大海
marine|adj. 海的；与海有关的；n.  水兵；海军陆战队士兵；舰队；海运业
navigation|n. 导航；航行；航海
gulf|n. 海湾；鸿沟；隔阂
beach|n. 海滩；沙滩
coast|n. 海岸；海滨
shore|n. 岸；滨
tide|n. 潮汐；潮流
current|n. （水、气、电）流；趋势；adj. 当前的；流通的
brook|n. 小河；溪；v. 忍受；容忍
stream|n. 流；溪；v. 流；流动
source|n. 来源；出处；源泉；源头；提供资料者；v. 寻找货源
shallow|adj. 浅的；浅薄的
superficial|adj. 表面的；肤浅的；浅薄的
flat|adj. 平坦的；扁平的；平淡无味的；（说话）断然的；（轮胎）瘪了的；n. 公寓；平坦部分；adv. 直接地
smooth|adj. 平坦的；平滑的；v. 使平坦；使平滑
rough|adj. 粗糙的；粗暴的；粗略的；艰苦的；adv. 粗野地；艰苦地
sandy|adj. 含沙的；沙质的；多沙的
stony|adj. 多石的；石头砌的；残酷的；冷酷的；无情的
vertical|adj. 竖的；垂直的
steep|adj. 陡峭的；急剧升降的；v. 浸；泡
parallel|adj. 平行的；相似的；相同的；v. 平行；类似；n. 类似的事物；相似之处
narrow|adj. 狭窄的；窄小的；v. 使窄小
Oceania|n. 大洋洲
mainland|n. 大陆；本土
peninsula|n. 半岛
climate|n. 气候；（社会）风气；一般（社会）趋势
weather|n. 天气；v. 使受风吹雨打；风干；经受住
meteorology|n. 气象学
mild|adj. 温和的；轻微的
heating|n. 加热；采暖；供暖设备；v. 加热；“heat”的现在分词
moderate|adj. 中等的；适度的；温和的；稳健的；v. （使）缓和；节制；n. 温和派人士
warm|adj. 温暖的；v. （使）变暖
thermal|adj. 热的；保热的；温热的
tropics|n. 热带地区；n. 回归线；热带；“tropic”的复数
arid|adj. 干旱的；贫瘠的；枯燥无趣的
moist|adj. 潮湿的；湿润的
damp|adj. 潮湿的；n. 潮湿；v. 使潮湿
humid|adj. 潮湿的；湿润的
snowy|adj. 下雪的；多雪的
frost|n. 霜；霜冻；严寒；v. 结霜
hail|n. 冰雹；v. 下冰雹；呼喊；欢呼；把…誉为
thaw|v. 使融解；解冻；变缓和；n. 融雪
chill|n. 寒冷；寒意；v. 变冷；使冰冷；adj. 寒冷的
freeze|v. （使）结冰；（使）冻结；n. 严寒期；冻结
frigid|adj. 寒冷的；冷淡的；性冷淡的（女子）
tremble|v. 发抖；打颤；战栗；焦虑；n. 震颤；发抖；战栗；焦虑
shiver|v. 哆嗦；颤抖；n. 哆嗦；颤抖
thunder|n. 雷；雷声；v. 打雷；雷鸣；怒吼
lightning|n. 闪电
stormy|adj. 暴风雨的；感情激烈的；情绪激昂的
downpour|n. 倾盆大雨；暴雨
rainfall|n. 降雨量；下雨
sprinkle|v. 洒；撒；下小雨；n. 洒；撒；小雨；少量
rainbow|n. 彩虹
shower|n. 淋浴；阵雨；一阵
Celsius|adj. 摄氏的；n. 摄氏度
temperature|n. 温度；气温；体温
forecast|n. 预测；预报；v. 预测；预报
peak|n. 高峰；顶峰；帽檐；v. 达到高峰；达到¸高值；adj. ¸高的；高峰期的
mount|v. 逐渐增加；骑上；登上；装上；安放；n. 山；峰
mountain|n. 山；山脉；一大堆；大量
range|n. （变化）范围；一系列；山脉；v. 包括（各种不同的人或物）；（在某范围内）变化
ridge|n. 脊；屋脊；山脊
slope|n. 斜坡；坡度；v. 倾斜；有坡度
valley|n. 山谷；溪谷；流域
hillside|n. 山坡；山腰
overlook|v. 忽略；俯视
southern|adj. 南部的
southeast|n. 东南；adj. 位于东南的；向东南的；adv. 在东南；向东南
southwest|n. 西南；adv. 在西南；向西南；adj. 位于西南的；向西南的
northeast|n. 东北；adv. 向东北；adj. 东北的
northwest|n. 西北；adj. 西北的；adv. 向西北
eastern|adj. 东方的；东部的
oriental|adj. 东方的（尤指中国和日本）
inevitable|adj. 不可避免的；必定的
irreversible|adj. 不可逆转的；不可挽回的
irregularly|adv. 不规则地；无规律地
inappropriate|adj. 不适当的；不合宜的
abnormal|adj. 不正常的
sediment|n. 沉积物；沉淀物
silt|n. 淤泥； 淤积；v. 使淤塞
muddy|adj. 泥泞的；模糊不清的；v. 使沾上泥；弄糊涂
clay|n. 黏土；粘土
dirt|n. 污垢；泥土；尘土
rural|adj. 农村的；乡村的
suburb|n. 市郊；郊区
outskirts|n. 郊区
remote|adj. 偏远的；久远的；渺茫的；n. 遥控器
desolate|adj. 荒凉的；孤寂凄凉的；v. 使荒无人烟；使孤寂凄凉
distant|adj. 遥远的；远处的；疏远的；冷漠的
adjacent|adj. 相邻的；邻近的
toxic|adj. 有毒的；中毒的；n. 毒物；毒剂
pollution|n. 污染；污染物
pollutant|n. 污染物
contaminate|v. 污染；弄脏
geology|n. 地质学
border|n. 边界；边疆；v. 和…毗邻；与…接壤
margin|n. 边缘；差额；利润；页边的空白处；余地
fringe|n. 流苏；边缘；刘海；v. 作为…的边缘
plate|n. 盘子；碟子
debris|n. 碎片；残骸；残渣
crack|n. 裂缝；裂纹；噼啪声；v. 断裂；破裂；打击；使崩溃
gap|n. 缺口；缝隙；差距；隔阂
splendid|adj. 壮观的；辉煌的；极好的
grand|adj. 壮丽的；堂皇的；痛快的；重大的；总的；n. 一千美元（或英镑）；大钢琴
magnificent|adj. 壮丽的；宏伟的；华丽的
super|adj. 超级的；极好的
interesting|adj. 有趣的
dramatic|adj. 急剧的；激动人心的；戏剧（性）的
wilderness|n. 荒野；荒地；荒原
desert|n. 沙漠；荒漠；v. 抛弃
deforest|v. 滥伐…的森林；乱砍…的树木
barren|adj. 贫瘠的；不结果实的；不孕的；无价值的
fertile|adj. 肥沃的；多产的；富饶的；有繁殖力的
fertilise|v. 使肥沃；使受孕；施肥
solar|adj. 太阳的；太阳能的
lunar|adj. 月球的；月亮的；阴历的
calendar|n. 日历
sunrise|n. 日出；黎明
sunset|n. 夕阳；落日
eclipse|n. 日食；月食；黯然失色；v. 使失色
dusk|n. 黄昏；薄暮
heaven|n. 天堂；天国
paradise|n. 天堂
sunshine|n. 阳光
shade|n. 荫；遮蔽处；阴影；v. 遮蔽；画阴影
shadow|n. 影子；阴影；阴暗；v. 投阴影于；跟踪
vapour|n. 水蒸气
evaporate|v. （使）蒸发；消失
circulate|v. 循环；流通；散布
precipitate|v. 使发生；沉淀；凝结；猛摔；n. 沉淀物；冷凝物；adj. 迅猛的；贸然轻率的
reservoir|n. 水库；蓄水池
waterfall|n. 瀑布
fountain|n. 喷泉；源泉
spring|n. 春天；弹簧；泉；v. 跳；跃；蹦；突然猛烈地移动
dew|n. 露；露水
pour|v. 倒；倾倒；蜂拥而来
drain|v. 排水；流掉；弄干；饮尽；消耗；n. 排水；下水道
drip|n. 水滴；v. 滴落
drown|v. 淹没；溺死
blow|n. 吹；打击；v. 吹；打击
puff|n. 吸；吹；喷；喘息；（烟、气等的）一缕；粉扑；酥皮点心；吹嘘；v. 吸；吹；喷；冒出（烟或蒸汽）；急促喘息；气喘吁吁；吹嘘
gush|v. 喷涌；滔滔不绝地说；n. 涌出；喷出
dense|adj. 密集的；稠密的；愚钝的
intensity|n. 强度；强烈；剧烈
intensive|adj. 密集的；增强的
emerge|v. 浮现；显露；暴露
flash|v. 闪光；闪现；n. 闪光；一刹那
float|v. 浮动；漂浮
environment|n. 环境
surrounding|adj. 周围的；附近的；v. 环绕；围绕；“surround”的现在分词
condition|n. 状态；条件；环境；v. 使适应；影响；保养
situation|n. 情况；形势；情境
nature|n. 自然；本性
natural|adj. 自然的；天然的
artificial|adj. 人造的；人工的；假的
synthetic|adj. 合成的；人造的；综合的
petrol|n. 汽油
gas|n. 气体；气态；汽油；天然气；煤气
gasoline|n. 汽油【美】
petroleum|n. 石油
photosynthesis|n. 光合作用
respire|v. 呼吸
dioxide|n. 二氧化物
vegetation|n. 草木；（统称）植物
herb|n. 药草；香草
perennial|adj. 永久的；反复出现的；多年生的；n. 多年生植物
botany|n. 植物学
ecology|n. 生态；生态学
ecosystem|n. 生态系统
eco-friendly|adj. 对生态环境友好的；不妨害生态环境的
horticulture|n. 园艺（学）
organism|n. 生物体；有机体；有机组织
genetics|n. 遗传学
mutation|n. 转变；突变；变异
variation|n. 变化；变动
diversity|n. 多样性；多样化
hybridisation|n. 杂交
classify|v. 分类；归类
reproduce|v. 繁殖；复制
evolve|v. 形成；演变；进化
fluctuate|v. 波动；起伏不定
reclaim|v. 要求归还；收回；开垦；感化
cultivate|v. 培养；栽培
sow|v. 播种；散布
harvest|n. 收获；收成；v. 收割；收获
pluck|v. 摘；拔；猛拉；拨弹；n. 胆识；胆量；快而猛的拉
pick|v. 选择；挑选；摘；采
yield|v. 生产；获利；屈服；让步；n. 产量；利润
rear|v. 抚养；饲养；n. 后部；adj. 后面的
arable|adj. 可耕的；适于耕种
plough|n. 犁；耕地；v. 犁（田）；耕（地）；翻（土）
spade|n. 铁锹；（纸牌中的）黑桃
rake|n. 耙子；耙地机；v. 用耙子耙；扫掠过；搜索
stack|n. 一摞；一叠；一堆；大烟囱；v. 把…放成整齐的一摞
heap|n. 堆；大量；许多；v. 堆放；堆积；堆起
bundle|n. 捆；束；包
bunch|n. 束；串；捆；一群；一帮；一伙
vase|n. 花瓶
sunlight|n. 阳光；日光
short-day|adj. 短日照的
shade-tolerant|adj. 耐阴的
fungus|n. 霉菌；菌类；真菌
mould|n. 霉；模具；v. 发霉；铸造
pollen|n. 花粉
germinate|v. 使发芽或发育；使产生
seed|n. 种子；籽；v. 播种；结籽
burgeon|v. 迅速生长；急速增长
bud|n. 芽；蓓蕾；v. 发芽
flower|n. 花；花朵
blossom|v. 开花；兴旺；发展；n. （果树的）花朵；兴旺；发展
bloom|v. 开花；n. 开花；花
scent|n. 香味；香水；气息；察觉；v. 嗅出；使充满气味；觉察出
aromatic|adj. 芳香的；芳香族的；n. 香料；芳香植物
ripen|v. （使）成熟
fruit|n. 水果；成果；v. 结果实
wither|v. （使）枯萎；（使）衰弱
decompose|v. 分解；使腐烂
rot|n. 腐烂；腐败；v. （使）腐烂
decay|v. 腐烂；衰退；n. 腐烂；衰落
stale|adj. 不新鲜的；陈腐的
rainforest|n. 雨林
jungle|n. 丛林
plantation|n. 耕地；种植园
field|n. 田地；领域；场地；运动场；v. 处理，应付（问题、电话等）
terrace|n. 平台；梯田；阳台；v. 使成台地
timber|n. 木材
charcoal|n. 木炭
log|n. 原木；木头；航海日志；v. 伐木；（正式地）记载
logo|n. 标志；标识；商标
forestry|n. 林产；森林学；森林地
branch|n. 分支；树枝；分公司
trunk|n. 树干；躯干；大衣箱；象鼻子
bough|n. 大树枝；粗树枝
root|n. 根；根源；v. 生根
hay|n. 干草
straw|n. 稻草；吸管
reed|n. 芦苇；簧片
thorn|n. 刺；棘；荆棘
weed|n. 杂草；野草；v. 除草；铲除
grass|n. 草；草地；大麻；告密者；v. 使吃草；放牧；告发
meadow|n. 草地；牧场
lawn|n. 草坪；草地
olive|n. 橄榄
pine|n. 松树；松木；v. 渴望；苦思
vine|n. 藤；藤蔓；藤本植物；葡萄藤
violet|n. 紫罗兰；adj. 紫罗兰色的
tulip|n. 郁金香
mint|n. 薄荷；薄荷糖；铸币厂；大量的钱；v. 铸（币）；adj. 完好如新的
reef|n. 礁；礁脉；v. 收帆；缩帆
alga|n. 藻类；海藻
enzyme|n. 酶
catalyst|n. 催化剂；接触剂
release|n. 释放；发布；v. 释放；发布
emission|n. 散发；排放；放射
absorb|v. 吸收；理解；吸引；使全神贯注；缓冲
circulation|n. 循环；流通；发行量
exceed|v. 超过；超出
uptake|n. 摄取；领会
nutrient|adj. 营养的；n. 营养物
energy|n. 能源；能量；精力
surroundings|n. 环境；围绕物；“surrounding”的复数
mechanism|n. 机制；机械装置
counterbalance|v. 抵消；使平衡；n. 衡重体；平衡力
protect|v. 保护
preserve|v. 保存；保护；保持；n. （某群体）专有的活动；保护区
conservation|n. 保护；保存；节约（自然资源）
bush fire|phrase. 林火
extinguish|v. 熄灭；扑灭
destruct|n. 毁灭；自毁；v. 摧毁；自毁；adj. 为自毁而设计的
ruin|n. 毁灭；废墟；v. 毁灭；破坏
perish|v. 死；暴卒；毁灭
demolish|v. 毁坏；拆除；推翻
infringe|v. 侵犯；违反；侵害
undermine|v. 逐渐削弱；暗中损害
extinction|n. 灭绝；消亡
pattern|n. 模式；图案；样式；v. 形成图案；仿造
outcome|n. 结果；成果
impact|n. 冲击（力）；影响力；v. 冲击；撞击；对…产生影响
seasonal|adj. 季节的；季节性的
experimental|adj. 以实验为基础的；实验性的
favourable|adj. 赞成的；有利的；嘉许的
productive|adj. 生产的；多产的；富有成效的
effective|adj. 有效的；生效的
efficient|adj. 效率高的
considerable|adj. 重要的；相当大的；可观的
massive|adj. 大而重的；大规模的
immense|adj. 巨大的
maximal|adj. ¸大限度的；¸大的；¸高的
minimal|adj. ¸小的；极少的；¸低限度的
optimal|adj. ¸佳的；¸理想的
biologist|n. 生物学家
zoologist|n. 动物学家
ecologist|n. 生态学家；生态学者
botanist|n. 植物学家
mammal|n. 哺乳动物
primate|n. 灵长类（动物）；大主教
vertebrate|adj. 有脊骨的（动物）；n. 脊椎动物
reptile|n. 爬行动物；adj. 爬虫类的
amphibian|n. 两栖动物
carnivore|n. 食肉动物；食虫植物
herbivore|n. 食草动物
creature|n. 生物；动物
wildlife|n. 野生生物；adj. 野生动物的
fauna|n. 动物群；动物区系
flora|n. 植物群落
species|n. 物种；种类
flock|n. 群；v. 聚集；群集
herd|n. 兽群；牧群；芸芸众生；v. 放牧；（强制）集合
swarm|n. 群；蜂群；v. 云集；充满
throng|n. 人群；一大群；众多；v. 群集；挤满；涌进
crowd|n. 人群；群众；v. 拥挤；群集
beast|n. 兽；凶残的人
brute|n. 野兽；残忍的人；adj. 残忍的；野兽般的；粗暴的
cruel|adj. 残酷的；冷酷的
originate|v. 起源；发源；创始
derive|v. 起源；来自；源自；得到
stem|n. 柄；茎；词干；v. 阻止；起源于(~ from)
ancestor|n. 祖先；祖宗
descendant|n. 后裔；子孙；后代
offspring|n. 后代；子女；幼苗
subgroup|n. 子群；小群；小组；小团体
feed|v. 喂；吃；饲养；n. 饲养；喂养
breed|v. 饲养；交配繁殖；n. 品种
interbreed|v. （使）异种交配；（使）杂种繁殖
hybridise|v. 杂交
proliferate|v. 繁殖；激增；扩散
sterility|n. 无菌；不育；不孕
mate|n. 伙伴；伴侣；v. 使 ... 配对；交配
courtship|n. 求爱；恋爱；求偶
lay|v. 放置；安放；下蛋；adj. 外行的；非专业的；v. 躺；“lie”的过去式
hatch|v. 孵出；出壳；秘密策划；n. 舱口；小窗口
brood|v. 孵（蛋）；沉思；忧思；n. 一窝动物；一大家孩子
spawn|n. 卵；产物；v. 产卵
mature|adj. 成熟的；到期的；充分考虑的；v. 成熟；到期
skin|n. 皮肤；毛皮；外皮；v. 剥皮；削皮
claw|n. 爪；钳；v. 抓
paw|n. 爪子；脚爪
beak|n. 鸟喙
fin|n. 鳍；鳍状物；尾翼
wing|n. 翅膀；翼
plume|n. 羽毛；羽饰；（一）股；（一）团；v. 整理羽毛；用羽毛装饰；自夸
feather|n. 羽毛
fur|n. 毛皮；皮草；软毛
bristle|n. 刚毛；猪鬃；v. 大为恼怒；耸起毛发
curl|v. 卷；蜷缩；n. 卷曲
insect|n. 昆虫
worm|n. 蠕虫
pest|n. 害虫
parasite|n. 寄生虫；寄生生物；依赖他人过活者
spider|n. 蜘蛛
butterfly|n. 蝴蝶
mosquito|n. 蚊子
cricket|n. 板球；蟋蟀
penguin|n. 企鹅
seal|n. 海豹；印章；v. 密封；封上
tortoise|n. 乌龟
turtle|n. 龟；海龟
whale|n. 鲸；v. 捕鲸
kangaroo|n. 袋鼠
camel|n. 骆驼
panda|n. 熊猫
elephant|n. 大象
ivory|n. 象牙；乳白色
horn|n. 角；号角；喇叭
bear|n. 熊；v. 负荷；带有；忍受；承受；生（孩子）
wolf|n. 狼；残忍贪婪之人；色狼；v. 狼吞虎咽
dragon|n. 龙；悍妇
fox|n. 狐狸；狡猾的人
cub|n. 幼兽；年轻人
calf|n. 小牛；牛犊；小腿肚
pup|n. 小狗；（海豹等）幼崽
lamb|n. 羔羊；小羊；羔羊肉
cattle|n. 牛（复数名词）；家畜
ox|n. 公牛；（阉割的）公牛
bull|n. 公牛；雄性大动物；胡扯；废话
buffalo|n. 水牛；野牛
horse|n. 马；v. 骑马
zebra|n. 斑马
donkey|n. 驴
saddle|n. 马鞍；鞍座；v. 给（马）装鞍
harness|n. 马具；挽具；v. 套马具；驾驭；利用；治理
falcon|n. 猎鹰
hawk|n. 鹰；隼；v. 兜售；沿街叫卖；鹰扑；用力咳
eagle|n. 鹰
owl|n. 猫头鹰
swallow|v. 吞咽；轻信；n. 燕子；吞咽
sparrow|n. 麻雀
pigeon|n. 鸽子
crow|n. 乌鸦；雄鸡的啼声；v. 打鸣；啼叫；欢叫；自鸣得意
swan|n. 天鹅；v. 闲逛；随意旅行
goose|n. 鹅；雌鹅；鹅肉
cock|n. 公鸡
mouse|n. 老鼠；鼠标
rat|n. 老鼠；耗子
squirrel|n. 松鼠；v. 贮藏
hare|n. 野兔
frog|n. 青蛙
behaviour|n. 行为；举止；表现
bite|v. 咬；叮；上钩；n. 咬；咬伤；上钩
sting|v. 刺；刺痛；n. 刺；刺痛
bark|v. 狗吠；咆哮；厉声说；n. 犬吠声；树皮
roar|v. 吼叫；咆哮；n. 吼叫；咆哮
rub|v. 擦；摩擦；n. 擦；摩擦；阻碍
creep|v. 爬行；匍匐；蹑手蹑脚地走；汗毛直竖；n. 讨厌鬼；马屁精
crawl|v. 爬；爬行
habitat|n. 栖息地；居留地；产地
nest|n. 窝；鸟巢；（能叠放在一起的）一套物件；v. 筑巢；嵌套
hive|n. 蜂箱；蜂巢；蜂群；闹市；v. 使（蜂）入蜂箱；群居
cell|n. 细胞；小房间；牢房；单元格
cage|n. 笼子；vt. 把…关进笼子
stable|adj. 稳定的；牢固的；稳重的；n. 马厩；畜舍
barn|n. 谷仓；牲口棚
hedge|n. 树篱；防范措施；v. 用树篱围住；限制；避免
barrier|n. 屏障；障碍；栅栏
bar|n. 棒；条状物；（门、窗的）闩；酒吧；栅栏
anatomy|n. 解剖学；解剖；解剖体组织构造
epidemic|n. 流行病；adj. 流行性的
gene|n. 基因
germ|n. 病菌；萌芽
bacteria|n. 细菌；“bacterium”的复数
virus|n. 病毒
microbe|n. 微生物
metabolism|n. 新陈代谢
protein|n. 蛋白质
vitamin|n. 维生素；维他命
secrete|v. 分泌；隐藏；隐匿
excrete|v. 排泄；分泌
devour|v. 吞食；吞噬；狼吞虎咽地吃；如饥似渴地看
instinct|n. 本能；直觉
intuitive|adj. 直觉的
potential|n. 潜力；adj. 潜在的；可能的
intelligence|n. 智力；才智；情报
functional|adj. 功能的；实用的；起作用的
sensitive|adj. 敏感的；感情脆弱的；体贴的；善解人意的
flexible|adj. 灵活的；柔韧的
acoustic|adj. 声音的；音响的；听觉的；原声的
optical|adj. 视觉的；光学的
nocturnal|adj. 夜间活动的；夜间发生的
dormant|adj. 休眠的；蛰伏的；暂停活动的
hibernation|n. 冬眠
track|n. 轨道；踪迹；小路；跑道；v. 追踪；跟踪
trace|n. 痕迹；轨迹；微量；追踪；v. 追踪；追溯；仔细查找；描摹
alternate|adj. 交替的；轮流的；间隔的；v. （使）交替；（使）轮流；n. 代替者；候补者
prey|n. 猎物；受害者；受骗者；v. 捕食；坑害；折磨
predator|n. 掠夺者；捕食性动物；食肉动物
victim|n. 受害者
captive|n. 俘虏；adj. 被俘的，被监禁的；受控的
defensive|adj. 防卫的；防御的；辩护的；n. 守势；辩护
undergo|v. 经受；经历；遭受
suffer|v. 遭受；忍受
vulnerable|adj. 脆弱的；易受伤的
subsistence|n. 生存；生计；生活
exist|v. 存在；生存；活着
exterminate|v. 消灭；灭绝；根除
tame|adj. 驯化的；温顺的；枯燥无味的；v. 驯养；制服；控制
keeper|n. 看守人；饲养员；管理人
shepherd|n. 牧羊人；牧师；指导者；v. 照看；引领
galaxy|n. 星系；银河；银河系；一群出色的人（或物）
cosmos|n. 宇宙
universe|n. 宇宙
interstellar|adj. 星际的
terrestrial|adj. 陆地的；地球的；类似地球的；陆栖的
celestial|adj. 天空的；天体的；天国的
astronomy|n. 天文学
astrology|n. 占星术；占星学
astronaut|n. 宇航员；太空人
comet|n. 彗星
meteorite|n. 陨石；陨星
crater|n. 火山口；弹坑
dust|n. 粉尘；尘埃；v. 擦去…的灰尘
ash|n. 灰
envelope|n. 信封
chunk|n. 厚块；大片
spacecraft|n. 航天器；宇宙飞船
spaceship|n. 宇宙飞船；太空船
probe|n. 探针；探测器；探究；v. 探究；探查
module|n. 模块；组件；单元；功能块；舱
propulsion|n. 推进；推动力
pressure|n. 压力；压强；压迫；v. 对…施加压力
dynamics|n. 动力学；动态学
motion|n. 运动；动作；提议
vent|n. 排气口；发泄；表达；v. 排放；发泄；表达
tail|n. 尾巴；尾随者；v. 跟踪
curve|n. 曲线；弯曲；v. （使）弯成弧形
exploration|n. 探索；勘探；探险
expedition|n. 远征；探险；探险队；短途旅行；迅速
flyby|n. 飞越
observatory|n. 天文台；气象台
telescope|n. 望远镜
spectacle|n. 景象；奇观；场面；眼镜
orbit|n. 轨道；v. 绕...轨道而行
ecliptic|n. 黄道；adj. 黄道的
diameter|n. 直径
radius|n. 半径；范围
substance|n. 物质；物品；实质；主旨；要点
composition|n. 构成；作品，作曲；（学生）作文；创作技巧
compound|n. 化合物；大院；adj. 复合的；混合的；v. 使复杂化；加重
fossil|n. 化石；守旧的事物
sample|n. 样品；样本；v. 尝试，体验；抽样；节录
specimen|n. 标本；样品
particle|n. 微粒；粒子
molecule|n. 分子
atom|n. 原子
ion|n. 离子
electron|n. 电子
quantum|n. 量子
liquid|n. 液体；adj. 液体的；液态的
fluid|n. 流体；流质；adj. 流动的
solid|n. 固体；立体图形；adj. 固体的；坚固的；可靠的
synthesise|v. 合成；综合
formation|n. 形成；排列方式
method|n. 方法；办法
spectrum|n. 范围；幅度；光谱；波谱
dimension|n. 尺寸；维度
frequency|n. 频率；频数；频繁
signal|n. 信号；标志；v. 用信号通知
antenna|n. 触角；天线
circuit|n. 回路；环行；电路；巡回；v. 环行
refraction|n. 折光；折射
ultraviolet|adj. 紫外的；紫外线的；n. 紫外线辐射；紫外光
radioactive|adj. 放射性的
distinct|adj. 有区别的；清晰的；明显的
discernible|adj. 可辨别的
invisible|adj. 看不见的；无形的
collision|n. 碰撞；冲突
squash|v. 把…压扁（或压坏）；（使）挤进；制止；n. 拥挤；壁球
fragment|n. 碎片；断片；片段；v. （使）成碎片；（使）分裂
cataclysmic|adj. 灾难性的；大变动的
overwhelming|adj. 势不可挡的；压倒的；无法抗拒的；v. 淹没；覆盖；压倒；控制；“overwhelm”的现在分词
despair|v. 绝望；n. 绝望
desperate|adj. 绝望的；不顾一切的；拼死的；极度渴望的
hopeless|adj. 绝望的
education|n. 教育
primary|adj. ¸初的；首要的；初等的；小学的；原来的
secondary|adj. 第二的，次要的；中等的
university|n. 大学
college|n. 学院；大学
institute|n. 协会；学院；研究所；机构；v. 建立；制定；开创；开始
academy|n. 学院
learn|v. 学习
study|v. 学习；研究；n. 学习；研究；书房
acquire|v. 获得；得到；学会
knowledge|n. 知识；了解；学问；学识
expertise|n. 专门技能；专门知识
novice|n. 新手；初学者；新信徒
recruit|v. 征募；招收；招聘；n. 新兵；新成员
literate|adj. 识字的；有读写能力的；有文化的；n. 识字的人；有学问的人
illiteracy|n. 文盲；无知；缺乏教育
numerate|v. 数；计算；读（数）；adj. 识数的；有计算能力的
problem|n. 难题；问题
issue|n. 问题；发行（物）；重要议题；流出；v. 发行；发表；流出；在…上挑起争论
affair|n. 事务；事件；暧昧关系
controversial|adj. 有争议的
puzzle|n. 谜；难题；拼图；v. （使）迷惑；（使）伤脑筋
riddle|n. 谜语；费解的事；v. 解谜；出谜；使布满窟窿；打洞
obscure|adj. 昏暗的；不清楚的；无名的；v. 使模糊；使隐晦；使费解
instil|v. 逐步渗透；逐渐灌输
cram|v. 塞满；填鸭式学习；n. 仓促备考；死记硬背
emphasise|v. 强调；着重
enhance|v. 提高；增强
enable|v. 使能够；使可能
inspire|v. 鼓舞；激励；启迪；激起；促成
motive|n. 动机；目的
motivate|v. 引起动机；激发；激励
stimulate|v. 刺激；激励
spur|n. 马刺；鞭策；v. 刺激；鞭策
impetus|n. 冲力；推动力；刺激
indulge|v. 放任；沉溺；使满足；听任
spoil|v. 宠坏；搞糟；变质；n. 赃物；战利品
abuse|v. 滥用；虐待；辱骂；n. 滥用；虐待；辱骂
intelligent|adj. 有才智的；聪明的；明智的
clever|adj. 聪明的；灵巧的
smart|adj. 聪明的；敏捷的；时髦的；衣冠楚楚的；v. 剧痛；刺痛；感到难过
all-round|adj. 全能的；多方面的；多才多艺的
genius|n. 天才；天赋
elite|n. （社会）精英；上层人士；adj. 精英的；出类拔萃的
idiot|n. 白痴；笨蛋
wisdom|n. 智慧；明智；学问
wit|n. 机智（的人）；风趣（的人）；才智；头脑；智慧
aptitude|n. 天资；天赋；才能
capable|adj. 有能力的
excellent|adj. 优秀的；杰出的；卓越的
outstanding|adj. 杰出的；尚未处理的
brilliant|adj. 光辉的；明亮的；灿烂的；卓越的；极好的
prestige|n. 声望；威望；威信
reputation|n. 名声；名誉
eminent|adj. 著名的；非凡的；杰出的
notorious|adj. 声名狼藉的；臭名昭著的
esteem|v. 尊重；尊敬；n. 尊重；尊敬
respect|v. 尊重；尊敬；遵从；n. 尊重；尊敬；方面
diligent|adj. 勤勉的；勤奋的
painstaking|adj. 辛苦的；苦干的
skill|n. 技能；技巧；技术
approach|v. 接近；靠近；临近；处理；n. 方法；接近；靠近；路径
scheme|n. 阴谋；计划；v. 密谋；策划
headmaster|n. 校长
principal|adj. ¸重要的；主要的；本金的；n. 负责人；首长；校长；本金
dean|n. 学院院长；系主任
faculty|n. 才能；能力；全体教员；院系
professor|n. 教授；导师
scholar|n. 学者；奖学金获得者
scientist|n. 科学家
mentor|n. 导师；顾问；v. 指导；辅导
tutor|n. 导师；家庭教师；v. 当家教；指导；辅导
lecturer|n. 演讲者；讲师；授课老师
assistant|n. 助理；助手；adj. 助理的；辅助的
candidate|n. 候选人；应试者
degree|n. 度；程度；学位
qualify|v. 使合格；使具有资格
certify|v. 证明；保证；证实
license|n. 许可证；执照；v. 发许可证
permit|v. 允许；准许；n. 通行证；许可证；执照
diploma|n. 毕业文凭；学位证书
diplomat|n. 外交官；会耍手腕儿的人
ambassador|n. 大使
pupil|n. 小学生；瞳孔
graduate|n. 大学毕业生；学士学位获得者；v. 毕业
ceremony|n. 仪式；典礼
bachelor|n. 未婚男子；单身汉；学士（本科）
master|n. 主人；硕士；v. 掌握；精通
doctor|n. 医生；博士；v. 篡改
fresher|n. 大学一年级新生；新鲜人；adj. 新鲜的；“fresh”的比较级
sophomore|n. （大学）二年级学生
junior|adj. 年幼的；（职位或等级）较低的；n. 年幼者
senior|adj. 高级的；年长的；资深的；n. 上司；年长者；大四学生
alumni|n. 校友；“alumnus”的复数
campus|n. （大学、学院的）校园
orientation|n. 方向；定位；取向；岗前训练；入学介绍
platform|n. 平台；站台；月台
coed|n. （男女同校学校的）女学生；adj. 男女同校的
register|v. 注册；登记；n. 登记簿；现金出纳机
roster|n. 花名册；勤务簿
enrol|v. 登记；注册；招收；（使）加入
matriculation|n. 入学考试；大学入学许可；录取入学
accommodation|n. 住处；工作场所；停留处；膳宿；（交通工具内的）空间
dorm|n. (集体)宿舍
dining hall|phrase. 餐厅；食堂
canteen|n. 食堂
laboratory|n. 实验室
experiment|n. 实验；试验；v. 做试验；进行实验
data|n. 数据；资料
quantity|n. 量；数量；大量
quality|n. 质量；素质；品质
library|n. 图书馆
literature|n. 文学；文学作品
article|n. 文章；物品；项目；条款；冠词
author|n. 作者
tale|n. 故事；叙述；传说
fiction|n. 小说；虚构
story|n. 故事；小说； 轶事；假话
diary|n. 日记
poetry|n. 诗歌；诗作
magazine|n. 杂志
journal|n. 日志；日记；期刊；杂志
coverage|n. 覆盖范围；新闻报道
bibliography|n. 参考书目；书籍学；文献学
encyclopedia|n. 百科全书
biography|n. 传记
documentary|adj. 记录的；文书的；纪实的；n. 纪录片
series|n. 连续；系列
record|n. 记录；唱片；v. 记录；录制
file|n. 文件；档案；锉；v. 把…归档； 用锉£锉；提出（离婚诉讼或其他讼案）
profile|n. 侧面像；轮廓；简介；受公众注意的程度
draft|n. 草稿；v. 起草；草拟
sketch|n. 草图；素描；概述；v. 草拟；速写；简述
brochure|n. 小册子；手册；指南
manual|n. 说明书；指南；adj. 手工的；体力的
frame|n. 框架；结构；骨架；模式；v. 制定；框住；陷害；表达
index|n. 指标；索引；指数
catalogue|n. 目录
category|n. 类别
inventory|n. 详细目录；清单；储备；存货
content|n. 内容；含量；目录；adj. 满足的；v. 使满意
context|n. 上下文；语境；环境
list|n. 表；名单；v. 列出；（船）倾斜
chapter|n. 篇章
volume|n. 卷；册；体积；音量
reel|n. 卷筒；卷轴；卷盘；线轴；v. 卷；绕；踉跄；摇摇晃晃地挪动；蹒跚
subject|n. 主题；话题；学科；对象
object|n. 物体；目的；对象；宾语；v. 反对；有意见；讨厌
major|adj. 主要的；较多的；成年的；大调的；n. 主修课；成年人；少校；大调；v. 主修
minor|adj. 小的；次要的；轻微的；小调的；n. 未成年人
sociology|n. 社会学
politics|n. 政治；政治学
economics|n. 经济学；经济
marketing|n. 营销；促销；销售活动
accounting|n. 会计；会计学；v. 解释说明；“account”的现在分词
audit|v. 审计；查账；n. 审计；查账
statistics|n. 统计学；统计数字
psychology|n. 心理学；心理
philosophy|n. 哲学
logic|n. 逻辑
biology|n. 生物学
physics|n. 物理学
chemistry|n. 化学
agriculture|n. 农业
logistics|n. 物流；（军事）后勤学
geography|n. 地理；地理学
history|n. 历史；历史学
engineering|n. 工程；工程学
mechanics|n. 力学；机械学；构成法；运作方式；n. 技工；机械师；机修工；“mechanic”的复数
electronics|n. 电子学；电子器件
maths|n. 数学
arithmetic|n. 算术
geometry|n. 几何学
algebra|n. 代数
calculus|n. （人体内的）结石；微积分学
plus|prep. 加；加上；conj. 加；和；并且；adj. 正的；加的；超过的；n. 加号；正数；优势
sum|n. 总数；算术；金额；v. 概括
total|n. 总额；总计；v. 共计；总数达；adj. 总的；全部的
merger|n. 合并；兼并
equation|n. 方程式；等式
identical|adj. 相同的；同样的
minus|adj. 零下的；负的；n. 减号；负号；缺点；prep. 减去
subtract|v. 减去；扣除
multiply|v. 乘；增加；繁殖
divide|v. 分开；分隔；除以
dividend|n. 被除数；股份红利；股息
remainder|n. 剩余物；其余的人；余数；v. 廉价出售
rational|adj. 理性的；理智的；合理的
parameter|n. 参数；参量；决定因素；界限
variable|adj. 可变的；易变的；不稳定的；n. 变量；易变的东西
even|adv. 甚至；甚至于；adj. 偶数的；平坦的；v. 使平均；使相等；使平坦
odd|adj. 奇怪的；奇数的；不成对的；不经常的；adv. （用于数字后）大约
mean|v. 意思是；打算；导致；有意；对…严肃认真；adj. 低劣的；吝啬的；平均的；n. 平均数；中庸；居中
double|n. 两倍；v. （使）加倍；是…的两倍；把…对折
triple|adj. 三部分的；三方的；三倍的；n. 三倍的数；三个一组；v. 成为三倍；使增至三倍
quadruple|adj. 四倍的；四重的；n. 四部分；v. 成四倍；翻两番
multiple|adj. 多样的；多种的；n. 倍数
maximum|n. ¸大限度；¸大量；adj. ¸多的；¸大极限的
minimum|n. ¸小值；adj. ¸小量的
approximately|adv. 大约；大概
chart|n. 图表；v. 作图；记录；制定
graph|n. 图表；曲线图
diagram|n. 图表；图解
table|n. 桌子；台子；表格；v. 把…列入议事日程；搁置
matrix|n. 母体；发源地；矩阵
rectangle|n. 矩形；长方形
cube|n. 立方体；立方
angle|n. 角；角度；视角；v. 斜放；运用手段获得
triangle|n. 三角形；三角形物
diagonal|adj. 对角线的；斜的；n. 对角线；斜线
straight|adj. 直的；笔直的；正直的；率直的；adv. 直；径直；直接
circle|n. 圆；圈；v. 圈出；环绕
round|adj. 圆的；球形的；十足的；adv. 环绕；附近；prep. 环绕；在…周围；n. 圆；圆形物；巡回；回合；v. 绕过；拐过；使成圆形
dot|n. 小圆点；点；v. 在...上加点
sphere|n. 球体；范围
cone|n. 圆锥体；圆锥形物；球果；松球
extent|n. 长度；广度；程度
width|n. 宽度
length|n. 长度
decimal|adj. 小数的；十进位的；n. 小数
per cent|n. 百分之…
proportion|n. 比例；份额
rate|n. 比率； 率；速度；进度；价格；费用；地方税；等级；v. 估价；值得；定级；（被）认为；被评价
ratio|n. 比率；比值
fraction|n. 小部分；分数
scale|n. 规模；等级；秤；刻度；比例（尺）；v. 改变…大小；攀登
ounce|n. 少量；盎司
density|n. 浓密；密度
Fahrenheit|adj. 华氏温度计的；n. 华氏温度计
mercury|n. 水银；汞
battery|n. 电池；一组；一连串
volt|n. 伏特
radiate|v. 散发；发射（光或热）；辐射
emit|v. 发出；发射
transparent|adj. 透明的；显然的
hollow|adj. 中空的；空洞的
ozone|n. 臭氧
gravity|n. 重力；地心引力；严重性
friction|n. 摩擦；不和；争执
eccentric|adj. 古怪的；偏离轨道的；n. 怪人；偏离轨道运行
displace|v. 取代；移置；免职；迫使…离开家园
boil|v. 沸腾；煮；煮沸；n. 煮沸；沸点
melt|v. （使）融化；（使）熔化
dissolve|v. 溶解；解散；散去；失控
rust|n. 铁锈；v. 生锈
ferment|n. 发酵；酵素；动乱；v. （使）发酵；动乱
dilute|v. 稀释；adj. 经稀释的
acid|adj. 酸的；酸性的；刻薄的；n. 酸
noxious|adj. 有害的；有毒的；可憎的
static|adj. 静止的；不变的；n. 静电
inert|adj. 无行动的；无生气的；惰性的
inherent|adj. 固有的；内在的；天生的
formula|n. 公式；配方；方案；分子式
component|n. 成分；部分；零件；adj. 组成的；构成的
compose|v. 创作；组成；使镇定
mixture|n. 混合物；混合
blend|v. 混合；配合；融合
theory|n. 理论；学说
empirical|adj. 经验主义的；以经验为根据的
practical|adj. 实际的；实践的；实用的
doctrine|n. 学说；教义；教条
principle|n. 原则；原理
discipline|n. 纪律；训练；惩戒；学科；科目；v. 训练；约束自己；惩罚
term|n. 学期；术语；措辞；期限；条款；v. 把…称作；把…叫做
semester|n. 一学期；半学年
timetable|n. 时间表；时刻表；课程表
schedule|n. 日程表；时间表；v. 安排
deadline|n. ¸终期限
course|n. 课程；过程；一道菜；v. 快速流动；（思想或感情）涌动
lesson|n. 课；功课；课程；教训
curriculum|n. 课程
seminar|n. 研讨会；专题讨论
forum|n. 古罗马城镇的广场；论坛；讨论会
syllabus|n. 教学大纲；摘要
system|n. 系统；体系
rudimentary|adj. 基本的；初步的；未充分发展的
basic|adj. 基本的；基础的
fundamental|adj. 基本的；基础的；根本的；n. 基本原则；基本原理
elementary|adj. 基本的；初级的
profound|adj. 深刻的；渊博的；深奥的；深远的
surface|n. 表面；v. 显露；给…铺路面
compulsory|adj. 强制的；必须做的
prerequisite|n. 前提；先决条件；adj. 首要必备的
selective|adj. 选择的；选择性的；精挑细选的
elective|adj. 选举的；选修的；可选择的；n. 选修课程
assignment|n. 分配；指派；任务；作业
submit|v. 提交；屈服
preview|n. 预审；预看；试映；预习；v. 预映；预看；预习；写预评
review|n. 回顾；复习；审查；评论；v. 回顾；复习；审核；评论
revise|v. 修正；温习；校订
inspect|v. 检查；视察
consult|v. 咨询；查询；请教
skim|v. 撇去；略读；掠过
scan|v. 扫描；浏览；审视；细看；n. 扫描；浏览；扫描图
scrutinise|v. 详细检查；仔细察看
recite|v. 背诵；吟诵；细述
dictate|v. 听写；口授；命令；支配；影响；n. 指令
examination|n. 考试；检查；审查
test|v. 试验；测试；n. 试验；测验
quiz|n. 小测验；知识竞赛
presentation|n. 演出；展示；陈述；报告
plagiarise|v. 抄袭；剽窃
copy|n. 复制品；副本；v. 复制；拷贝
print|v. 打印；印刷；n. 打印；印刷
thesis|n. 论点；论文
essay|n. 散文；文章；尝试；企图；v. 企图；尝试
paper|n. 纸；报纸；论文；试卷；v. 用墙纸贴
dissertation|n. 专题论文；学位论文
project|n. 计划；方案；项目；课题；v. 预计；计划；投射；突出
heading|n. 标题；v. 前进；朝向；“head”的现在分词
outset|n. 开端；起始
outline|n. 轮廓；纲要；v. 描画轮廓；概述
point|n. 点；观点；要点；分数；v. 指向；指出；弄尖；瞄准
gist|n. 要点；大意；主旨
opinion|n. 意见；看法；观点
introduce|v. 介绍；引进
reference|n. 提及；涉及；参考；引用；介绍信
cite|v. 引用；提及，举例，引证；传讯
elicit|v. 引出；诱出；探出
quote|v. 引用；报价；n. 引用；引文；报价
extract|n. 提取物；摘录；精华；节录；v. 拔出；提取；摘录
abstract|adj. 抽象的；非具体的；深奥的；v. 提取；抽取；作…的摘要；n. 摘要；概要；抽象派艺术作品
summary|n. 总结；摘要
assume|v. 假定；设想；呈现；承担
presume|v. 假设；假定；设想；冒昧
suppose|v. 认为；假设；猜想
hypothesis|n. 假设；假说
postulate|v. 假定；要求；n. 假定；假设
speculate|v. 推测；思索；投机
predict|v. 预言；预测
perceive|v. 察觉；理解；发觉
detect|v. 察觉；查出；测出
discern|v. 辨明；识别；洞悉
recognise|v. 认出；意识到；承认
conscious|adj. 有意识的；有知觉的；刻意的
reckon|v. 计算；估计；认为；考虑到
deem|v. 认为；觉得
imply|v. 暗示；意味
deliberate|adj. 深思熟虑的；故意的；v. 深思熟虑；仔细考虑
represent|v. 代表；表现；体现；相当于
insist|v. 坚持；坚决要求
persist|v. 坚持；持续
understand|v. 理解
comprehend|v. 理解；领会；包含
analyse|v. 分析
diagnose|v. 诊断
infer|v. 推断；推知
deduce|v. 推断；演绎；推论
conclude|v. 推断出；得出结论；结束
analogy|n. 类比；类推；相似
compare|v. 比较；对比；比喻
contrast|n. 对照；反差；对立；v. 对比；和...形成对照
overlap|v. 交叠；使部分重叠；n. 重叠部分
contradiction|n. 矛盾；不一致；反驳
disagree|v. 不同意；不一致；不适合；不符
differ|v. 与…不同；与…相异
diverse|adj. 多种多样的；不同的
nuance|n. 细微差别
inductive|adj. 诱导的；归纳的；感应的
detail|n. 细节；详情；详细；v. 详述；细说；派遣
thorough|adj. 彻底的；完全的；详尽的
example|n. 例子；实例；榜样
instance|n. 例子；场合；情况
confirm|v. 证实；确认；批准
demonstrate|v. 演示；展示；证明；示威
illustrate|v. （举例）说明；给（书籍、杂志等）加插图
manifest|v. 表明；显现；使人注意到；adj. 明显的；n. 载货单；旅客名单
prove|v. 证明；证实
determine|v. 决心；决定；测定；确定
decide|v. 决定
resolve|v. 决心要；解决；（使）分解；n. 决心
survey|v. 调查；勘测；n. 调查；勘测
research|n. 研究；探索；调查；v. 研究；调查；探讨
observe|v. 观察；注意到；遵守；评论；庆祝
inquire|v. 询问；调查
query|n. 询问；疑问；问号；v. 询问；怀疑
questionnaire|n. 调查问卷；调查表
achieve|v. 完成；实现；达到；获得
accomplish|v. 完成；实现
attain|v. 达到；获得
credit|n. 赞扬；荣誉；赊账；信用；贷款；学分；v. 相信；给银行账户上存钱
score|n. 得分；分数；二十；总谱；乐谱；v. 得分；记分
mark|n. 记号；痕迹；分数；v. 做标记；（使）留痕迹；评分
grade|n. 等级；年级；级别；v. 分等级；给…评分
rank|n. 列；排；行列；阶层；等级；军衔；v. 排列；分类；分等级；adj. 繁茂的；恶臭的；讨厌的；极端的
row|n. 排；划船；吵闹；v. 划船；吵架
queue|n. 行列；长队；v. 排队
grant|v. 允许；承认；授予；n. 授予物；补助金
praise|v. 赞美；赞扬；n. 赞美；赞扬
appreciate|v. 欣赏；理解；感激；增值
feedback|n. 反馈
underestimate|v. 低估；对…估计不足；n. 低估；轻视
overestimate|v. 过高估计；n. 过高的估计
apply|v. 申请；应用；涂，敷
fellowship|n. 伙伴关系；情谊；团体；联谊会；奖学金
scholarship|n. 奖学金；学问；学识
reward|n. 奖励；报酬；v. 奖励；回报
award|v. 颁奖；授予；裁定；n. 奖品；裁定
prize|n. 奖赏；奖品；奖金；战利品；v. 珍视；珍藏；估价
fee|n. 费用
technology|n. 科技；技术
technique|n. 技术；工艺；技巧；技艺
polytechnic|n. 工艺专科学院；理工专科学院；adj. 工艺的
engineer|n. 工程师；机械师；v. 设计（工程）；策划
mechanic|n. 技工；机械师；机修工
advance|n. 发展；进步；提前；v. 前进；发展；提前；adj. 预先的；在前的
innovate|v. 改革；创新
breakthrough|n. 突破；突破性进展
gizmo|n. 小发明
patent|n. 专利；专利权；专利证书；adj. 有专利的；受专利保护的
devise|v. 想出；设计；发明
invent|v. 发明；创造
discover|v. 发现；查明；发觉
disclose|v. 揭露；透露；泄露
reveal|v. 揭露；泄露；（使）显露；n. （电视节目¸后的）揭示
uncover|v. 揭开；揭露
expose|v. 暴露；揭露；使遭受
domain|n. 领地；范围；领域
realm|n. 领域；王国
foundation|n. 创建；基础；根据；基金（会）
specialise|v. 专用于；专门研究
concentrate|v. 集中；浓缩；n. 浓缩液
focus|n. 中心点；焦点；v. 集中；聚焦
utilise|v. 利用
usage|n. 使用；用法
tester|n. 测试仪；测试器；测试员；试验员
device|n. 设备；装置；手段；策略；方法
appliance|n. 家用电器；器具
facility|n. 设施；特定场所；特色功能；资质
equipment|n. 设备；装备
instrument|n. 仪器；乐器；工具；手段；法律文件
tool|n. 工具；£具；器具；v. 用工具加工
gauge|n. 测量仪器；规格；计量器；评估；v. 测量；评估
measure|n. 衡量；量度；措施；方法；v. 测量；衡量；度量
calculate|v. 计算；推测
compute|v. 计算；估计；运算
count|v. 计算；清点；看作；有价值；n. 计数；计算
estimate|v. 估算；估价；n. 估价；估算
assess|v. 评定；评估；估算
evaluate|v. 估价；评价
accessory|n. 配件；附件；从犯；adj. 附属的
byproduct|n. 副产品；副产物
auxiliary|adj. 辅助的；附属的；n. 辅助物；附属物；助动词
versatile|adj. 多才多艺的；有多种技能的；多方面的
add|v. 加；增加
accumulate|v. 积累
assemble|v. 装配；集合
gather|v. 聚集；集合
attach|v. 系上；贴上；附加；使依附；使相关；隶属于
belong|v. 应在（某处）；属于
optics|n. 光学
microscope|n. 显微镜
lens|n. 透镜；镜片
radar|n. 雷达
echo|n. 回声；v. 回响
sensor|n. 传感器；敏感元件
multimedia|adj. 多媒体的；n. 多媒体
network|n. 网络；网路；网状物
browser|n. 浏览器；浏览（书本等）的人
dial|n. 拨号；刻度盘；v. 拨
microcomputer|n. 微型计算机
laptop|n. 便携式电脑；笔记本电脑
software|n. 软件
keyboard|n. 键盘
screen|n. 屏幕；屏风；掩蔽物；v. 筛查；掩蔽；放映
loudspeaker|n. 扬声器；喇叭
microphone|n. 麦克风；扩音器
cassette|n. 盒子；盒式磁带
tape|n. 磁带；胶带；录音带；带子；v. 录音；用带子捆；用胶带粘
binary|n. 二进制；二元；adj. 二进位的；二元的
digital|adj. 数字的；数码的
wireless|adj. 无线的；n. 无线电；（无线电）收音机
high-definition|adj. 非常鲜明的
audio|adj. 音频的；声音的
vision|n. 视野；视力；想象；幻象
fantasy|n. 幻想；奇幻
science fiction|phrase. 科幻作品
pump|n. 泵；抽水机；打气机；v. 抽水；打气
generator|n. 发电机；发生器
gear|n. 用具；齿轮；排挡；v. 换挡；调整；（使）适合
pivot|n. 枢；中心；旋转；v. 在枢轴上转动；以…为中心
hydraulic|adj. 水力的；水压的；液压的
drainage|n. 排水；排水系统；放水
sewage|n. 污水；污物；下水道
ventilation|n. 通风；通风装置
compress|v. 压缩；压榨；n. （外科）敷布
condense|v. （使）冷凝；浓缩；删节以求精简
refine|v. 精炼；改进
simplify|v. 简化
purify|v. 净化；使纯净；提纯
filter|n. 过滤器；v. 过滤
distil|v. 蒸馏；用蒸馏法提取；提炼
mode|n. 方式；样式；模式
prototype|n. 原型；模型；典型
framework|n. 骨架；支架；框架
aspect|n. 方面；模样；朝向
phase|n. 阶段；时期；相位；v. 分阶段进行
operate|v. 操作；运转；施行手术
facilitate|v. 使容易；使便利；促进；帮助
transform|v. 转变；改造
convert|v. 转换；转变；变换；使...改变信仰；n. 皈依者
alter|v. 变更；改动
shift|v. 变换位置；转移；换（挡）；轮班；n. 转移；移位；转变；轮班
turn|v. 转身；转弯；转动；转变；n. 轮到的机会；拐弯；转变
adapt|v. 适应；改编
adjust|v. 调整；使适合；使适应
pinpoint|v. 指出（原因）；精准定位；n. 极小之物；精确位置；adj. 精准的
accurate|adj. 精确的；无误的
precise|adj. 准确的；确切的
correct|adj. 正确的；v. 改正；修正
error|n. 错误；差错
mistake|n. 错误；失误；v. 弄错；误解
flaw|n. 瑕疵；缺陷；裂痕；v. 使有裂纹；使有缺陷
wrong|adj. 错误的；n. 错误；adv. 错误地
fault|n. 故障；过错；缺陷；断层；v. 发现错误；找出缺点
stumble|v. 绊倒；蹒跚；失误 ；n. 绊倒
contingency|n. 偶然事故；意外事件
circumstance|n. 环境；情况
culture|n. 文化；培养
civilisation|n. 文明；文化
renaissance|n. 复兴
epic|n. 史诗；叙事诗；adj. 史诗的；叙事诗的；宏丽的
ideology|n. 意识形态；思想体系
tradition|n. 传统；惯例
convention|n. 习俗；大会；协定
custom|n. 习俗；习惯
feudalism|n. 封建主义；封建制度
slavery|n. 奴隶制；奴隶身份
ethical|adj. 伦理的；道德的
moral|adj. 道德的；道义上的；n. 寓意；道德
tribe|n. 部落；部族
aboriginal|adj. 土著的；原始的；n. 土著居民
inhabitant|n. 居住者；居民
native|adj. 本土的；当地的；天生的；n. 土著；本地人；本国人
local|adj. 局部的；本地的
exotic|adj. 外来的；外国来的；奇异的
foreigner|n. 外国人；外来人
alien|n. 外星人；外国人；外侨；adj. 外国的；陌生的；相异的
anthropologist|n. 人类学家
humanitarian|n. 人道主义者；慈善家；adj. 人道主义的；慈善的
heritage|n. 遗产；继承物；传统
inherit|v. 继承；遗传
antique|n. 古董；古代文物；adj. 古老的；过时的
archaeology|n. 考古学
excavate|v. 挖掘；发掘
museum|n. 博物馆
pottery|n. 陶器；陶土；陶器作坊；制陶手艺
engrave|v. 在…上雕刻；铭记
decorate|v. 装饰；装修
religion|n. 宗教
ritual|n. （宗教等的）仪式；典礼；例行习惯；adj. 仪式的；惯常的；例行公事的
etiquette|n. 礼仪；礼节
belief|n. 信仰；信念
soul|n. 灵魂；心灵
spirit|n. 精神；情绪；人物；灵魂；心灵；勇气；酒精；v. 神秘地带走
sacred|adj. 宗教的；神圣的；庄严的
hallowed|adj. 神圣化的； 受崇敬的
holy|adj. 神圣的；圣洁的
Pope|n.  教皇；罗马教皇
bishop|n. 主教；（国际象棋的）象
missionary|n. 传教士；adj. 传教（士）的
priest|n. 牧师；神父；教士
Bible|n. 《圣经》
church|n. 教堂
cathedral|n. 大教堂
choir|n. 唱诗班；合唱
monk|n. 僧侣；修道士
temple|n. 庙宇；太阳穴
pagoda|n. 塔；宝塔
empire|n. 帝国
imperial|adj. 帝国的；皇帝的；英制的（度量衡）
royal|adj. 皇家的；盛大的
dynasty|n. 朝代；王朝
chronology|n. 年代学；年表；按年代次序的排列
emperor|n. 皇帝；帝王
king|n. 国王
queen|n. 女王；王后
prince|n. 王子；君主
princess|n. 公主；王妃
majesty|n. ¸高权威；王权；威严
nobility|n. 贵族阶级；高贵的身份；高贵；高尚
lord|n. 主；上帝；勋爵；统治者
knight|n. 骑士；（英国）爵士；武士
guardian|n. 保护人；监护人
nostalgia|n. 怀恋；怀旧；乡愁
homesick|adj. 思乡的；想家的
celebrity|n. 名人；名声
status|n. 地位；身份；状态；职称；重要性
background|n. 背景；经历
experience|v. 经历；体验；n. 经验；阅历
anecdote|n. 趣闻；轶事
accident|n. 意外；事故；意外事件
incident|n. 事件；事变
thrive|v. 兴旺；繁荣；茁壮成长
prosperity|n. 繁荣；兴旺
setback|n. 退步；挫折
adversity|n. 逆境；不幸
language|n. 语言
symbol|n. 符号；象征；标志
sign|n. 标志；符号；告示牌；手势；征兆；v. 签名；做标记
gesture|n. 手势；姿态；姿势
handwriting|n. 笔迹；手写
pictograph|n. 象形文字；象形图；古代石壁画
wedge|n. 楔子；三角木；楔形物；v. 把…楔住 ；将…挤入（或塞进、插入）
knot|n. （树） 节；结；郁结；群；簇；节；v. 打结；使纠结；紧绷；使痉挛
linguistics|n. 语言学
semantic|adj. 语义的
syntax|n. 句法；句子结构学；语构；语法
grammar|n. 语法
phonetics|n. 语音学；adj. 语音的；发音的
pronounce|v. 发音；宣告
intonation|n. 语调；声调；音准
inflection|n. 变音；转调；曲折变化
dialect|n. 方言；地方话
accent|n. 口音；腔调；v. 强调；重读
utterance|n. 言辞；言语；言论
oral|adj. 口述的；口头的
verbal|adj. 口头的；语言的；用词的；动词的
syllable|n. 音节
phoneme|n. 音位
vowel|n. 元音；母音
consonant|n. 辅音；辅音字母；adj. 一致的；相符的
alphabet|n. 字母表
logogram|n. 词符
vocabulary|n. 词汇量；词汇表
dictionary|n. 词典；字典
idiom|n. 成语；习语；惯用语
phrase|n. 短语；词组；v. 叙述；措辞
clause|n. 从句；条款
expression|n. 表达；表情；措辞
tense|adj. 紧张的；拉紧的；n. 时态
prefix|n. 前Ð；v. 在…前面加
suffix|n. 后Ð；词尾
abbreviation|n. 缩写；略号
synonym|n. 同义词
antonym|n. 反义词
noun|n. 名词
singular|adj. 单数的；单个的；特异的
plural|n. 复数；adj. 复数的；多元的
pronoun|n. 代词
verb|n. 动词
adjective|adj. 形容词的；n. 形容词
adverb|n. 副词
preposition|n. 介词
conjunction|n. 联合；连接词；同时发生
consistent|adj. 一致的；始终如一的
complicated|adj. 复杂的
complex|adj. 复杂的；费解的；n. 综合楼（群）；情结
compile|v. 汇编；编制
version|n. 版本；样式
translate|v. 翻译；转化
paraphrase|v. 意译；解释；改述；n. 释义；意译；改述
interpret|v. 口译；把…理解为；解释
narrate|v. 叙述；给（电视或电影）作旁白
illuminate|v. 照亮；阐明；解释
decipher|v. 破译；解读；n. 密电译文
eloquence|n. 雄辩；口才
communicate|v. 沟通；交流
discussion|n. 讨论；商讨
brainstorm|v. 脑力激荡；集思广益；n. 计上心头；集体研讨
debate|v. 辩论；争论；n. 辩论；争论
commentary|n. 解说词；评论；实况报导
negotiate|v. 谈判；协商；通过；越过
contention|n. 争论；论点；争辩
medium|n. 媒介；方法；adj. 中等的；适中的
press|v. 按；压；n. 按；压；出版社；新闻界
journalist|n. 新闻记者
critic|n. 评论家；批评者
commentator|n. 评论员；解说员
exponent|n. 阐述者；拥护者；代表者；指数
announcer|n. 广播员；告知者；报幕员
correspondent|n. 通讯记者；通信者
messenger|n. 送信者；通信员
editor|n. 编辑（者）；剪辑员
typist|n. 打字员
handout|n. 施舍物；救济品；印刷品；讲义
leaflet|n. 传单；单页宣传品；复叶的一叶；v. 散发传单
propaganda|n. 宣传
publish|v. 发布；出版
disseminate|v. 传播；散播；扩散
foresee|v. 预见；预知
anticipate|v. 预料；预期；期望；抢先；提前使用
expect|v. 期待；期望；预期
await|v. 等待
pastime|n. 消遣；娱乐
entertain|v. 娱乐；使快乐；款待；心存；怀有
recreation|n. 消遣；娱乐
amuse|v. 逗乐；娱乐；消遣
gossip|n. 流言蜚语；爱说长道短的人；闲话；v. 散播（流言蜚语）
rumour|n. 谣言；v. 谣传
consensus|n. 一致；共识
festival|n. 节日
feast|n. 盛宴；宴会；节日；享受；v. 尽情享用（美味佳肴）；款宴；享乐
programme|n. 节目；计划；程序；v. 安排；计划；编程
rehearsal|n. 排练；预演
perform|v. 表演；执行；履行；表现
imitate|v. 模仿；仿效
mimic|v. 模仿；模拟；n. 模仿者；仿制品；adj. 模仿的；摹拟的
simulate|v. 假装；冒充；模仿；模拟
circus|n. 马戏团
magic|n. 魔术；魔法；adj. 魔术（似）的；神奇的
drama|n. 戏剧；话剧
concert|n. 音乐会；演奏会；一致；和谐；v. 协调一致行动
symphony|n. 交响乐；交响曲
orchestra|n. 管弦乐队
ballet|n. 芭蕾舞；芭蕾
opera|n. 歌剧
comedy|n. 喜剧
tragedy|n. 悲剧；灾难；惨事
animation|n. 活跃；生气；兴奋；动画
film|n. 电影；底片；薄薄的一层；v. 拍摄电影
movie|n. 电影
X-rated|adj. X级的
artist|n. 艺术家；画家
craftsman|n. 工匠；手艺人；匠人
painter|n. 画家；油漆工
role|n. 角色；职能；作用
scene|n. 场景；现场；景色
stage|n. 阶段；时期；舞台；v. 举行；上演
gallery|n. 画廊；美术馆
exhibition|n. 展览；展出
aesthetic|adj. 审美的；美学的
collect|v. 收集
select|v. 选择；挑选；adj. 精心挑选的
opt|v. 选择；决定
photograph|n. 照片；相片；v. 照相；拍照
portrait|n. 肖像；画像
painting|n. 绘画；油画；v. 刷油漆；用颜料画；“paint”的现在分词
sculpture|n. 雕刻（术）；雕塑品；雕刻品；v. 雕塑；刻蚀
draw|v. 拉；拽；画；提取；吸引
depict|v. 描述；描绘
describe|v. 描述
carve|v. 雕刻；切开
improvise|v. 即兴创作；即兴表演；临时准备
musical|adj. 音乐的；擅长音乐的；喜欢音乐的；悦耳的；n. 音乐剧；音乐歌舞片
classical|adj. 古典的
jazz|n. 爵士乐
rock|n. 岩石；摇滚乐；v. （使）摇动；震撼；（使）摇晃
hip-hop|n. 街舞；嘻哈文化；adj. 嘻哈的；嘻哈文化的
pop|n. 砰的一声；流行音乐；汽水；v. 发出砰的一声；突然地行动；adj. 流行的；通俗的；adv. 砰地
lyric|n. 抒情诗；歌词；adj. 抒情的
band|n. 乐队；带子；一伙
solo|n. 独奏；独唱；独舞；单独表演；adj. 单独的；独唱的；独奏的；adv. 单独地；独自地；独奏地
melody|n. 旋律；曲调
rhythm|n. 节奏；韵律
tone|n. 音调；色调；语气；氛围；强健状况；v. 使协调；使健壮
tune|v. 调整；调音；n. 曲调；调子
disc|n. 圆盘；磁碟；唱片
piano|n. 钢琴
violin|n. 小提琴
cello|n. 大提琴
guitar|n. 吉他
harmonica|n. 口琴
trumpet|n. 喇叭；小号；v. 宣扬；吹嘘
drum|n. 鼓；v. 敲打
flute|n. 长笛
competition|n. 竞争；比赛
tournament|n. 锦标赛；比赛；联赛
Olympic|adj. 奥林匹克的
sponsor|n. 赞助商；发起人；v. 赞助；主办
patron|n. 赞助人；资助人；老主顾
athlete|n. 运动员；田径运动员
champion|n. 冠军；优胜者；拥护者；v. 拥护；支持
spectator|n. 观众；旁观者
volunteer|n. 志愿者；v. 自愿做
famous|adj. 著名的；出名的
well-known|adj. 众所周知的；著名的
energetic|adj. 精力旺盛的；有活力的
vigorous|adj. 精力充沛的；茂盛的
stadium|n. 体育场；运动场
gym|n. 健身房；体育馆
training|n. 训练；培训；锻炼；v. 训练；培训； “train”的现在分词
exercise|n. 练习；锻炼；运动；行使；v. 运用；使用；锻炼；使担忧
indoor|adj. 户内的；室内的
outdoor|adj. 户外的
mobile|adj. 可移动的；易变的
movement|n. 活动；运动；动作；乐章
yoga|n. 瑜伽
sprawl|v. 伸开四肢；蔓延；杂乱无序地拓展；n. 伸开四肢；蔓延；杂乱无序的拓展
stretch|v. 伸展；延伸；持续；n. 伸展；弹性；一段
strain|n. 压力；拉伤；拉力；（动植物的）品种；v. 损伤；竭力；拉紧
chess|n. 国际象棋
badminton|n. 羽毛球运动；羽毛球
golf|n. 高尔夫球
billiards|n. 台球
soccer|n. 足球
tennis|n. 网球
volleyball|n. 排球
hockey|n. 曲棍球
goal|n. 目标；进球得分；球门
bat|n. 蝙蝠；球拍；球棒；v. 击（球）
racket|n. 喧哗；球拍；v. 吵闹；用球拍打
kick|n. 踢；踹；v. 踢；踹
knock|v. 敲；撞；击；打；n. 撞击；敲击
flip|v. 快速翻转；迅速按；轻弹；轻击；n. 浏览；空翻；轻抛；捻掷；adj. 轻率的；无礼的；冒失的
pitch|v. 投掷；扎营；（猛地）向前倾跌；力荐（某主张）；n. 球场；程度（¸高点）；音高；沥青；宣传论点
throw|v. 扔；抛；丢；投；n. 扔；抛；摔；投
toss|v. （随意地）抛掷；向后甩
slide|v. （使）滑动；下滑；n. 幻灯片；滑梯
slip|v. 滑倒；滑落；溜走；悄悄地放；n. 滑倒；溜走；疏忽；纸片
glide|v. 滑行；滑动；滑翔；轻快无声地移动；n. 滑行；滑动；滑翔；滑音
tumble|v. 跌倒；摔倒；暴跌；n. 摔倒；混乱；暴跌
ski|v. 滑雪
skate|v. 溜冰；n. 旱冰鞋
cycling|n. 骑自行车；v. 循环；骑自行车；“cycle”的现在分词
dive|v. 潜水；跳水；暴跌；n. 潜水；跳水；暴跌
drift|v. 飘；漂流；漂移；n. 流动；趋势
jump|n. 跳；跳跃；v. 跳；跳跃
leap|v. 跳跃；n. 跳跃
plunge|v. 投入；跳入；n. 跳进；骤降
hop|v. 单腿跳；跳跃；齐足跳；跃过；n. 跳跃；蹦跳；啤酒花
bounce|v. 弹跳；反弹；n. 弹跳；跳动
tent|n. 帐篷；帐棚
camp|n. 营地；阵营；兵营；v. 宿营；露营；使扎营（住宿）
picnic|n. 野餐；v. 去野餐
hunt|v. 打猎；搜寻
race|n. 种族；赛跑；竞争；v. 比赛；快速移动
marathon|n. 马拉松赛跑；持久赛跑；耐力赛
pedestrian|n. 行人；步行者；adj. 步行的；呆板的；平淡无奇的
pace|n. 一步；步伐；步速；v. 踱步；调整步调
step|n. 步；步骤；踏级；步伐；v. 踩；踏；行走
excursion|n. 远足；短途旅行；涉猎某事
cruise|v. 乘船游览；航游；缓慢行进；n. 乘船游览；航游
trip|n. 旅行；旅程；v. 绊倒；出差错；轻快地走
vacation|n. 假期；度假
hike|n. 远足；（费用）增加；v. 远足；（费用）增加
jog|v. 慢跑；轻碰；轻撞；n. 慢跑；轻碰；轻撞
stride|v. 大步行走；跨一大步；n. 大步；步伐
wander|v. 徘徊；漫游
linger|v. 徘徊；逗留；流连；磨蹭
lag|v. 缓慢移动；滞后；n. 时间间隔
climb|v. 攀爬；爬升
pull|v. 拉；拖；牵；拔；n. 拉；拖；牵；拔
drag|v. 拖；硬拉；拖沓；n. 累赘；阻力
bend|v. （使）弯曲；弯腰；n. 弯曲处
bow|n. 弓；蝴蝶结；鞠躬；v. （使）鞠躬
stuff|n. 东西；原料；v. 塞；填充
item|n. 项目；条款；一则； 一件物品或商品
merchandise|n. 商品；货物；v. 推销；销售
souvenir|n. 纪念品；纪念物
artefact|n. 人工制品；手工艺品；加工品
material|n. 材料；原料；adj. 物质的
raw|adj. 生的；未加工处理过的
crude|adj. 未加工的；粗鲁的；简陋的
necessity|n. 需要；必需品
outfit|n. 全套装备；整套服装；配备；机构；v. 装备；配置设备；供给服装
kit|n. 成套工具；配套元件；装备
utensil|n. 用具；器具
garbage|n. 垃圾；废物
rubbish|n. 垃圾；废物
trash|n. 垃圾；无价值的东西；v. 丢弃；损坏；诋毁
recycle|v. 再循环
reuse|n. 回用；重复使用；再次使用；v. 再使用；重复使用
litter|n. 垃圾；杂物；一窝小崽；担架；v. 乱扔；乱丢杂物
waste|n. 垃圾；废物；浪费；v. 浪费；白费；糟蹋；adj. 荒芜的；废弃的；丢弃的
junk|n. 废旧杂物；无价值的东西
landfill|n. 垃圾填埋（场）；垃圾堆填（区）
sewerage|n. 排水系统；污水
detergent|n. 洗涤剂；洗衣粉；去垢剂
lotion|n. 洗剂；洗液；乳液；护肤液
shampoo|n. 洗发水；洗发精；洗发香波；v. 洗头发
soap|n. 肥皂
tub|n. 桶；盆；浴盆
plug|n. 插头；塞子；栓；宣传；v. 堵；塞；插上；大肆宣传
tap|n. 水龙头；轻拍；轻敲；轻击；v. 轻拍；轻敲；利用；提取
pipe|n. 管子；管道；烟斗；v. 吹笛；以管输送
tube|n. 管子；管状物；[英]地铁；电视机
mop|n. 拖把；洗碗刷；乱蓬蓬的头发；v. 用拖把拖；擦
broom|n. 扫帚
sweep|v. 扫；打扫；掠过；扫荡；n. 扫；打扫；掠过；席卷
mattress|n. 褥垫；床垫
carpet|n. 地毯
rug|n. 小地毯；垫子
mat|n. 垫子；席子
cushion|n. 靠垫；软垫；缓冲物；v. 加衬垫；对…起缓冲作用；减轻…
pad|n. 垫；爪垫；便笺簿；v. 放轻脚步走
blanket|n. 毛毯；厚的覆盖物；adj. 包括所有的；v. 覆盖
quilt|n. 被褥；被子
sheet|n. 薄板；被单；纸张；（薄）片
pillow|n. 枕头
sponge|n. 海绵动物；海绵块；v. 用海绵揩拭
towel|n. 毛巾；手巾
staple|n. 订书钉；主要产品；主要部分；主食；v. 用订书机装订；adj. 主要的；重要的
nail|n. 钉子；指甲；v. 钉；抓住；使固定
razor|n. 剃须£；刮脸£
shave|v. 刮；剃
fuse|n. 保险丝；导火线；引信；v. 由于保险丝烧断而电路不通；熔接；结合
cable|n. 电缆；钢索
cord|n. 细绳；绳索
strand|n. 一缕；一股；方面；海滨；河岸；v. 使滞留；使搁浅
match|n. 比赛；火柴；v. 相配
candle|n. 蜡烛
wax|n. 蜡；v. 给…上蜡
portfolio|n. 文件夹；公事包；作品集；部长职务；投资组合
paperback|n. 平装书；平装本
pamphlet|n. 小册子
tissue|n. 组织；纸巾；薄纸
cover|v. 遮盖；包括；报道；n. 封面；遮盖物；庇护所
Xerox|n. 施乐复印机（商标名称）；静电复印；v. 复印；影印
duplicate|v. 复制；复印；再做一次；n. 副本；复制品；完全一样的东西；adj. 复制的；副本的；完全一样的
memorandum|n. 备忘录；便笺
stationery|n. 文具
glue|n. 胶；胶水；v. 胶合；粘合；紧附于
ink|n. 油墨；墨水；v. 给…上油墨
rubber|n. 橡胶；橡皮；橡皮擦
scissors|n. 剪£
shear|v. 剪（羊毛）；剪切
edge|n. 边缘；边沿；锋；刃；锋利；优势；v. 使锋利；使侧着移动
rim|n. 边；缘
element|n. 元素；要素；成分
factor|n. 因素；要素；因数；代理人；倍数；系数；v. 把…因素包括进去；分解成因子；做代理商（或管家）
section|n. 部分；部门；章节
tag|n. 标记；标签；捉人游戏；v. 加标签于；把…称作；紧随；连接
label|n. 标签；v. 用标签标明
badge|n. 徽章
bolt|n. 插销；螺栓；闪电；v. 用插销闩上
knob|n. 球形把手；旋钮；疙瘩；节；v. 鼓起；使有球形突出物
handle|v. 处理；操纵；n. 柄；把手
shutter|n. 百叶窗；（照相机的）快门
curtain|n. 帷幕；窗帘
pane|n. 一块窗格玻璃
opacity|n. 不透明；费解；晦涩
jar|n. 缸；坛子；（玻璃）罐子；广口瓶；v. （使）震动；令人不快；冲突；不一致
barrel|n. 桶；枪管
bucket|n. 水桶；吊桶
pail|n. 桶；一桶之量
phone|n. 电话；v. 打电话
bell|n. 钟（声）；铃（声）
camera|n. 照相机；摄像机
portable|adj. 便携式的；手提的；n. 便携式打字机
spotlight|n. 聚光灯；公众注意的中心；v. 聚光照明； 使公众注意；使突出醒目
lantern|n. 灯笼；提灯
bulb|n. 电灯泡；球茎状物；球茎；鳞茎
flashlight|n. 手电筒；闪光灯
refrigerator|n. 冰箱
fridge|n. 冰箱
vacuum|n. 真空；空虚；v. 用真空吸尘器打扫
fan|n. 风扇；迷；v. 煽动；吹拂
switch|v. 转换；n. 开关
hurdle|n. 跨栏；障碍；难关；v. 越过障碍；克服
fence|n. 篱笆；栅栏；围栏；v. 用篱笆围住；防护；击剑
pedal|n. 踏板；踩踏板；v. 用脚踏动
shelf|n. 架子；搁板
ladder|n. 梯子；阶梯
lift|v. 举起；抬起；提起；解除；n. 电梯；搭便车
stool|n. 凳子；粪便
drawer|n. 抽屉；起草者；开票人
umbrella|n. 伞；雨伞
raincoat|n. 雨衣
dredge|v. 疏浚；挖掘；n. 挖泥船；疏浚机
can|v. 能；n. 金属罐
mill|n. 磨坊；磨粉机；面粉厂；工厂；纺织厂；碾碎器；v. 碾碎；磨碎
forge|v. 伪造；制造；建立（联系等）；n. 锻造车间
alloy|n. 合金；v. 把…铸成合金
metal|n. 金属
iron|n. 铁；铁器；熨斗；镣铐；adj. 铁制的；坚强的；顽强的；v. 熨烫；用铁装备
lead|v. 领导；带领；导致；n. 铅
brass|n. 黄铜；黄铜制品；厚脸皮
bronze|n. 青铜；青铜色；adj. 青铜色的
cement|n. 水泥；胶合剂；黏固粉；v. 用水泥涂；粘牢；巩固
lime|n. 石灰；酸橙
plaster|n. 灰泥；膏药；熟石膏；v. 涂以灰泥；敷以膏药
leather|n. 皮革
plastic|n. 塑料；adj. 塑料的；可塑的；不自然的
fibre|n. 纤维
fabric|n. 织物；布料；构造；（建筑物的）结构
knit|v. 编织；编结
weave|v. 编织；编制
canvas|n. 帆布；帆布画布
linen|n. 亚麻布；亚麻织品；adj. 亚麻布制的；亚麻色的
cotton|n. 棉；棉花；棉布
nylon|n. 尼龙
lumber|n. 木材；v. 笨拙地移动；伐木
wooden|adj. 木制的；木头的；生硬笨拙的
mine|n. 矿；地雷；pron. 我的（东西）；v. 采矿；埋地雷
pit|n. 坑；凹洞；矿井；v. 使凹陷
fuel|n. 燃料；燃油；刺激因素；v. 加燃料；加剧
lubricate|v. 润滑；加润滑油于
diamond|n. 钻石；菱形；金刚石
crystal|n. 水晶；结晶；adj. 晶体的
inferior|adj. 较差的；次等的；下级的
counterfeit|adj. 伪造的；v. 仿造，伪造；n. 赝品
fake|n. 赝品；假货；冒充者；v. 伪造；假装；冒充；adj. 假的；冒充的；伪造的
fragile|adj. 易碎的；不牢固的；脆弱的
miniature|adj. 微型的；小型的；v. 使成小型；n. 微型
available|adj. 可获得的；可用的；有空的
durable|adj. 耐用的；持久的
fashion|n. 时尚；流行；姿态；方式；v. 制作；把...塑造成；使适应
style|n. 风格；样式；方式；文体
trend|n. 趋势；走向；v. 倾向
tendency|n. 趋势；倾向
popularity|n. 普及；流行
vogue|n. 时髦；时兴
prevail|v. 获胜；盛行；劝服
model|n. 模型；模特儿；模范；型号；v. 将…做成模型；当模特儿
icon|n. 图标；画像；雕像；圣像；偶像
idol|n. 偶像；神像
luxury|n. 奢华；奢侈品；难得的享受
extravagant|adj. 奢侈的；过度的
jewellery|n. 珠宝；首饰
jewel|n. 宝石；珠宝
gem|n. 宝石；珍品；受人重视者；v. 饰以宝石
jade|n. 玉；翡翠
adorn|v. 装饰；佩戴；使美观
ornament|n. 装饰；装饰品；v. 装饰；美化
embellish|v. 美化；装饰；渲染
embroider|v. 刺绣；绣（花）；加以渲染（或润色）
hairdressing|n. 理发；理发业
pigment|n. 色素；颜料
dye|v. 给...染色 ；n. 染料
masquerade|n. 化妆舞会；伪装；v. 伪装；冒充
veil|n. 面纱；遮盖物；v. 蒙上面纱；隐藏；掩饰
costume|n. 服装；衣服；戏服；v. 给…穿上服装
fascinate|v. 强烈吸引住；使着迷
decent|adj. 像样的；体面的；正派的
exquisite|adj. 精美的；细腻的；强烈的
grace|n. 优雅；恩宠
elegance|n. 高雅；典雅；优雅
perfect|adj. 完备的；完美的；v. 使完美
appearance|n. 出现；露面；外观；外表
cosmetics|n. 化妆品；美容品；“cosmetic”的复数
make-up|n. 化妆品；性格；构成；补考
handsome|adj. 英俊的；丰厚的
charming|adj. 迷人的；娇媚的；v. 使着迷；“charm”的现在分词
pretty|adv. 很；相当；adj. 漂亮的
beautiful|adj. 漂亮的
ugly|adj. 丑陋的；难看的
dress|n. 连衣裙；衣服；v. （给…）穿衣服
clothe|v. 给...穿衣；供给衣服
uniform|adj. 一致的；统一的；n. 制服
garment|n. 衣服；外衣；v. 给…穿衣服
laundry|n. 洗衣店；要洗的衣物
wardrobe|n. 衣柜；衣橱
overall|adv. 全部；总计；大致上；n. （工作时穿的）罩衣；adj. 总的；全面的；总体的
overcoat|n. 大衣；外套
robe|n. 长袍；v. （使）穿上长袍
gown|n. 长袍；礼服；长外衣
sweater|n. 毛衣
jacket|n. 夹克衫
skirt|n. 裙子；下摆；边缘；v. 位于…的边缘；绕着…走；避开
jeans|n. 牛仔裤
trousers|n. 裤子；长裤
clasp|n. 钩；扣；紧握；紧抱；v. 抱紧；握紧；扣紧
button|n. 纽扣；按钮
glove|n. 手套
hat|n. 帽子
cap|n. 帽子；v. 覆盖…的顶部
brim|n. 边；边缘；帽边；v. （装）满；（使）溢出
scarf|n. 围巾；头巾；v. 围（围巾）；披（披巾）
handkerchief|n. 手帕；方巾
purse|n. 钱包；钱袋；女用小包；资金；v. 噘嘴
wallet|n. 钱包；皮夹；钱夹
vest|n. 背心；马甲；汗衫；v. 授予；使穿衣
wrap|v. 包；缠绕；覆盖；穿外衣；遮蔽；n. 外套；围巾；包裹；包装材料
cloak|n. 斗篷；掩护物；v. 隐瞒；掩饰
collar|n. 衣领；领子；v. 抓住；给....上领子
sleeve|n. 袖子
sock|n. 短袜
stocking|n. 长袜
slipper|n. 拖鞋
boot|n. 靴子；长筒靴
lace|n. 鞋带；饰带；花边；缎带；v. 系带子；饰以花边
tailor|v. 剪裁；缝制；调整使适应；n. 裁缝
sew|v. 缝制；缝补
spin|v. 纺（纱）；旋转；疾驰；n. 旋转
stitch|n. 针脚；缝线；一针；v. 缝；缝合
needle|n. 针
pin|n. 大头针；别针；v. （用大头钉等）固定
string|n. 弦；线；一连串
thread|n. 线；线索；思路；v. 穿线于；穿过
strap|n. 带子；皮带；皮条；v. 用带缚住；包扎
stripe|n. 条纹；类型
ribbon|n. 缎带；带状物；丝带
belt|n. 腰带；皮带；传送带
chain|n. 链条；链子；v. 用铁链锁住
bracelet|n. 手镯
necklace|n. 项链
bead|n. 有孔的小珠；珠状物；滴；v. 用珠装饰；形成珠状
textile|n. 纺织品；纺织业
velvet|n. 天鹅绒；丝绒；adj. 天鹅绒的
wool|n. 羊毛；毛线
patch|n. 补丁；一小片；小块地；v. 打补丁；缝补
rag|n. 旧布，破布
shabby|adj. 破旧的；肮脏破烂的；衣衫褴褛的
tight|adj. 紧的；adv. 紧紧地
colour|n. 颜色；v. 着色
white|adj. 白色的；n. 白色
yellow|adj. 黄色的；n. 黄色
brown|adj. 褐色的；棕色的；n. 褐色；棕色
grey|adj. 灰色的；暗淡的；n. 灰色；暗淡
pink|n. 粉红色；adj. 粉红色的
purple|n. 紫色；adj. 紫色的
tan|n. 晒成棕褐色的肤色；adj. 棕褐色的；棕黄色的；v. 将皮肤晒成棕褐色
fade|v. 逐渐消失；褪色；凋谢
stain|n. 污点；v. 玷污
blot|n. 污点；墨渍；v. （用纸或布）吸干；弄脏
figure|n. 数字；身材；重要或有名的人物；v. 计算；认为；弄懂
slender|adj. 苗条的；微薄的
slight|adj. 轻微的；微小的；细瘦的；n. 轻慢；v. 轻视
food|n. 食物
diet|n. 日常饮食；v. 节制饮食
appetite|n. 胃口；食欲；嗜好；爱好
treat|v. 对待；招待；治疗；n. 款待
cater|v. 迎合；满足需要；供应酒菜
provision|n. 供应；预备；储粮；规定；条款
edible|adj. 可食用的；可以吃的
recipe|n. 食谱；烹饪法；处方；秘诀
restaurant|n. 餐厅；餐馆
refectory|n. 食堂；餐厅
cafeteria|n. 自助餐厅；自助食堂
buffet|n. 自助餐；饮食柜台；v. 反复敲打；连续猛击
barbecue|n. 户外烧烤；烤肉；烤架；v. 烧烤
supper|n. 晚饭；晚餐
banquet|n. 宴会；盛宴
refreshment|n. 茶点和饮料；提神；心旷神怡
snack|n. 小吃；点心；快餐
appetiser|n. 开胃菜；开胃品
cuisine|n. 烹饪；菜肴；烹调风格
menu|n. 菜单
order|n. 顺序；条理；订单；命令；（生物学的）目；v. 订购；命令；点餐；整理
takeaway|n. 外卖餐馆；外卖食物
chef|n. 主厨；厨师
gourmet|n. 美食家
vegetarian|n. 素食者；食草动物；adj. 素食者的；素菜的
cutlery|n. 餐具（£、叉和匙）
silver|n. 银；银色；银器；adj. 银的；银色的；v. 镀银于；使 ... 成银色
ceramic|n. 陶瓷制品；陶瓷器；adj. 陶质的；制陶的
porcelain|n. 瓷；瓷器
bowl|n. 碗；一碗…；碗状物；v. 投掷；滚动
dish|n. 盘；碟；菜肴
saucer|n. 茶托；碟子
tray|n. 托盘；浅盘
fork|n. 叉子；分岔；分支；v. 分岔；用叉子叉
knife|n. £
spoon|n. 勺子；汤匙
glass|n. 玻璃；玻璃杯
mug|n. （有柄的）大杯；v. 对…行凶抢劫
kettle|n. 水壶
pan|n. 平底锅
pot|n. 壶；锅；罐；瓢；盆；v. 罐装；栽入盆中；射杀
stove|n. 火炉
furnace|n. 熔炉；火炉
oven|n. 烤箱；烤炉
tin|n. 锡；罐头
lid|n. 盖子
drink|v. 喝；喝酒；n. 饮料；酒
beverage|n. 饮料
juice|n. 果汁
soda|n. 苏打；苏打水
coffee|n. 咖啡
alcohol|n. 酒精；乙醇；含酒精的饮料
liquor|n. 酒；烈酒
whisky|n. 威士忌
brandy|n. 白兰地
drunk|adj. 喝醉的；v. 喝；喝酒；“drink”的过去分词
tobacco|n. 烟草；烟叶
cigarette|n. 香烟；纸烟
sober|adj. 清醒的；严肃的；素淡的；v. （使）清醒，变得持重
vegetable|n. 蔬菜
tomato|n. 西红柿；番茄
potato|n. 土豆；马铃薯
pea|n. 豌豆
bean|n. 豆；豆科植物
cucumber|n. 黄瓜
cabbage|n. 卷心菜
onion|n. 洋葱
mushroom|n. 蘑菇；v. 迅速增长
eggplant|n. 茄子
carrot|n. 胡萝卜
turnip|n. 芜菁；萝卜
radish|n. 小萝卜
peel|n. 果皮；v. 剥落；去皮
strip|v. 剥去；剥夺；脱衣；n. 长条；条状
hull|n. 外壳；皮；船身；船体；v. 去壳
cherry|n. 樱桃；樱桃树；adj. 樱桃色的
berry|n. 浆果
grape|n. 葡萄
papaya|n. 木瓜
peach|n. 桃子；桃树；桃红色
pear|n. 梨子
plum|n. 梅子；李子；紫红色；青紫色；令人垂涎的东西；adj. 令人垂涎的；吸引人的
orange|adj. 橙色的；n. 橙色；橙子
melon|n. 瓜；甜瓜
lemon|n. 柠檬；柠檬色
kiwi|n. 几维鸟；奇异果
crop|n. 农作物；收成；v. 修剪；种植；收割
corn|n. 玉米；谷物
grain|n. 谷物；颗粒
wheat|n. 小麦；小麦色
reap|v. 收割；收获；获得
flour|n. 面粉
porridge|n. 粥；麦片粥
paste|n. 面团；浆糊；v. 裱糊；粘贴
livestock|n. 家畜；牲畜
chicken|n. 鸡肉；鸡
turkey|n. 火鸡
beef|n. 牛肉
pork|n. 猪肉
mutton|n. 羊肉
sausage|n. 香肠；腊肠
fish|n. 鱼；鱼肉；v. 钓鱼；捕鱼
pond|n. 池塘
rod|n. 杆；棒
dairy|adj. 牛奶的；乳品的；n. 乳品店
milk|n. 奶；v. 挤奶
yogurt|n. 酸奶；酵母乳
cream|n. 奶油；乳脂；护肤霜
cheese|n. 奶酪
butter|n. 黄油；奶油；v. 涂黄油于...上
salad|n. 色拉；沙拉
sandwich|n. 三明治
hamburger|n. 汉堡包
loaf|n. 一条（面包）；v. 游荡；虚度光阴
pie|n. 果馅饼
pizza|n. 比萨饼；披萨；意大利薄饼
pasta|n. 意大利面食
spaghetti|n. 意大利式细面条
soup|n. 汤
pudding|n. 布丁
biscuit|n. 饼干
jam|n. 果酱；堵塞；困境；v. 挤紧；使堵塞；猛地做
nut|n. 坚果；螺母；疯子；着迷的人
chocolate|n. 巧克力；adj. 巧克力的
ice cream|n. 冰淇淋
vanilla|n. 香草；香草精；adj. 寻常的；无特色的
mustard|n. 芥末；芥末酱
wasabi|n. 芥末
pepper|n. 胡椒粉；辣椒；v. 使布满；向…不断射击
ginger|n. 生姜
garlic|n. 大蒜
scallion|n. 青葱
vinegar|n. 醋
salt|n. 盐；食盐；v. 用盐腌；加盐于
sugar|n. 糖；食糖；v. 在…中加糖
candy|n. 糖果
honey|n. 蜂蜜；甜蜜；宝贝
flavour|n. 风味；滋味；味道；v. 给…添风味；调味
sour|adj. 酸的；不友好的；坏脾气的；v. （使）变酸
sweet|adj. 甜的；悦人的
bitter|adj. 有苦味的；痛苦的；刺痛的；激烈而不快的
spicy|adj. 含香料的；辣的；下流的
delicious|adj. 美味的；可口的
yummy|adj. 美味的；可口的
tasty|adj. 美味的；可口的
hunger|n. 饥饿；渴求；v. 使饥饿；渴望
thirsty|adj. 口渴的；渴望的
spice|n. 香料；调味品；趣味
sauce|n. 酱汁；调味汁
ketchup|n. 番茄酱
perfume|n. 香水；香味；v. 给…添加香味
ingredient|n. 成分；配料；要素；因素
supplement|n. 补充物；附录；附加费；v. 补充；增加
digest|n. 摘要；文摘；v. 消化；领会
cook|n. 厨师；v. 烹饪
bake|v. 烘；烤；焙
fry|v. 油炸；油煎
roast|v. 烤；烘烤；n. 烤肉；烘烤；adj. 烤的；焙的
toast|n. 烤面包片；敬酒；干杯；v. 向...祝酒；为...干杯；烘烤
suck|v. 吮；吮吸
lick|v. 舔；轻拍；吞卷；克服；n. 舔；少许
chew|v. 咀嚼
gum|n. 树胶；口香糖；牙龈；v. 用胶粘
soak|v. 浸泡；吸收；n. 浸泡
dip|v. 浸；蘸；（暂时）减少；n. 浸；蘸；下降
squeeze|v. 捏；榨；挤（进）；n. 捏；榨；挤
stir|v. 搅拌；搅动；激起
grind|v. 碾碎；磨碎；n. 苦差事
slice|n. 切片；薄片；部分；片段；v. 切成片
architecture|n. 体系结构；建筑学；建筑设计
erection|n. （阴茎）勃起；建造；竖立；建筑物
structure|n. 结构；建筑物；v. 组织；安排
construct|v. 建造；构造；作（几何图）；n. 结构（物）；构想；概念
obstruct|v. 阻碍；阻塞；阻挡
establish|v. 建立；确立；制订；使被安排好；使认定；使承认
build|v. 建筑；建造；逐步加强；n. 构造；体格；体形
found|v. 建立；创建；v. 找到；发现；认为； “find”的过去式和过去分词
concrete|adj. 具体的；有形的；混凝土的；n. 混凝土；具体物；v. 用混凝土覆盖
steel|n. 钢；钢铁
stability|n. 固定；牢固；稳定
site|n. 位置；场所
venue|n. 举办地点；会场；（比赛）地点
landmark|n. 地标；里程碑；界标；adj. 有重大意义的
situated|adj. 位于…的；处于…的境地的；v. 使位于；使坐落于 ；“situate”的过去式和过去分词
locate|v. 位于；查找…的地点；确定…的位置；使坐落于
reside|v. 居住；（性质）存在；属于
inhabit|v. 居住于；栖息
migrate|v. 迁移；移居；迁徙
settle|v. 定居；安顿；解决
dwelling|n. 住宅；住所；v. 居住；栖身；沉湎于；“dwell”的现在分词
skyscraper|n. 摩天大楼
villa|n. 别墅
mansion|n. 大厦；宅邸
apartment|n. 单元住宅；公寓住宅
hostel|n. 旅社；招待所；（校外）学生宿舍
lodge|n. 小舍；传达室；v. 存放；借宿；提出（抗议）
hut|n. 小屋；棚屋；茅屋
cabin|n. 小棚屋；船舱；客舱
cellar|n. 地窖；地下室
shed|n. 棚屋；v. 摆脱；去除；使脱落
cottage|n. 村舍；小屋；小别墅
nursery|n. 托儿所；苗圃
cradle|n. 摇篮；发源地；吊架；v. 轻轻抱着
shelter|n. 避难所；庇护所；v. 庇护；遮蔽
block|n. 块；街区；大楼；大厦；障碍物；v. 阻塞；阻碍
grid|n. 网格；格栅；方格；系统网络
aisle|n. 过道；通道；走廊
porch|n. 门廊
corridor|n. 走廊
stair|n. 楼梯；梯级
staircase|n. 楼梯
storey|n. 楼层
layer|n. 层；层次
elevator|n. 电梯；升降机
escalator|n. 自动扶梯；电动扶梯
handrail|n. 扶栏
pillar|n. 柱子；栋梁
column|n. 圆柱；专栏；纵；列
beam|n. 光线；横梁；v. 眉开眼笑；发射（电波或光）
vault|n. 拱顶；墓穴；金库；撑竿跳；v. 跳跃
arch|n. 拱形；拱门；弧形；v. （使）成弓形；adj. 调皮的； 撒娇的；主要的；首要的
ceiling|n. 天花板
eaves|n. 屋檐
chimney|n. 烟囱
reception|n. 接待；招待会
lobby|v. 游说；n. 大厅；休息室
bench|n. 长凳；工作台
parlour|n. 客厅；起居室；营业室
fireplace|n. 壁炉
radiator|n. 散热器；暖气装置
living room|phrase. 客厅；起居室
cabinet|n. 储藏柜；内阁
balcony|n. 阳台
kitchen|n. 厨房
lavatory|n. 盥洗室；厕所
toilet|n. 厕所；马桶；卫生间；盥洗室
bath|n. 洗澡；浴室；v. 给…洗澡
basin|n. 脸盆；水池；盆地；流域
reserve|v. 保留；储备；预订；n. 储备；保留；保护区；候补
store|n. 商店；店铺；仓库；储存；v. 贮藏；存储
mall|n. 购物中心
supermarket|n. 超市；超级市场
booth|n. 小亭；临时货摊；隔间
casino|n. 赌场
studio|n. 演播室；录音棚；工作室
downtown|n. 市中心区；（市中）商业区；adj. 市区的；adv. 在市区；往市区
urban|adj. 城市的；都市的
peripheral|adj. 外围的；周边的；次要的；n. 外围设备
vicinity|n. 附近；周围地区；邻近地区
room|n. 房间；空间
void|adj. 空的；缺乏的；无效的；n. 空白；空虚；v. 取消；使无效
spacious|adj. 宽敞的；广阔的
airtight|adj. 密封的；不透气的；无懈可击的
expanse|n. 辽阔；广袤
plaza|n. 广场；市场
castle|n. 城堡
carpenter|n. 木匠；木工
mason|n. 石匠；（美国英语）泥瓦工
tile|n. 瓦；瓷砖
brickwork|n. 砌砖
suspension|n. 悬浮；中止；暂缓
hook|n. 钩；挂钩；v. 钩住
lever|n. 操纵杆；杠杆；v. 撬动
scaffold|n. 脚手架；断头台；绞刑架
infrastructure|n. 基础设施
apparatus|n. 装置；仪器；器械；器官
crane|n. 起重机；鹤
malfunction|n. 故障；失灵；v. 失灵；发生故障
maintain|v. 保持；坚持认为；维护；供养
fix|v. 修理；固定；确定
mend|v. 修理；修补；康复；n. 修补；补丁；痊愈
modify|v. 更改；修饰
trim|v. 修剪；装饰；adj. 整齐的；整洁的；n. 修剪
weld|v. 焊接；n. 焊接
saw|v. 锯；v. 看；“see”的过去式；n. 锯子
screw|n. 螺丝钉；v. 拧紧
drill|n. 钻机；反复的练习；v. 钻孔；（教某人）反复练习
plumb|n. 铅锤；垂直；v. （用铅垂）测量；探测；敷设水管；adv. 恰恰；彻底地；adj. 垂直的；完全的
viaduct|n. 高架桥；高架铁路
span|n. 间距；时距；跨度；v. 持续；跨越；涉及
dam|n. 水坝；拦河坝
install|v. 安装；安置；（以正式仪式）使就职
furnish|v. 布置家具；配备；供给；提供
placement|n. 放置；安排；实习工作
layout|n. 布局；布置
design|v. 设计；计划；谋划；构思；n. 设计；图案；花样；企图；图谋
entrance|n. 入口；进入；到场；v. 使出神；使入迷
entry|n. 进入；参与；参赛作品；条目；入口
enter|v. 进入；进去
exit|n. 出口；v. 退出；离去
outside|adv. 在外面；n. 外面；外边；外部；prep. 在...外；adj. 外面的；外界的
outward|adj. 向外的；表面的
exterior|n. 外观；外表；adj. 外面的；外部的
external|adj. 外部的；外界的
inner|adj. 内部的；内心的
interior|adj. 内部的；里面的；n. 内部
inward|adv. 向内地；adj. 在内的；内心的
internal|adj. 内部的；国内的；n. 内脏；本质
navigate|v. 导航；绕行；理解；应付（复杂情况）
voyage|n. 航行；航海；v. 航行；远航
aviation|n. 航空；航空学；飞行（术）
journey|n. 旅行；旅程
travel|v. 旅游；旅行；n. 旅游；旅行
safari|n. （在非洲的）旅行；狩猎旅行
parade|n. 游行；阅兵；v. 游行；阅兵
haunt|v. 出没；萦绕；长期困扰；常去；n. 常到之地
attraction|n. 吸引；吸引力
memorial|n. 纪念物； 纪念碑；adj. 纪念的；哀悼的
pyramid|n. 金字塔；棱锥体
port|n. 港口
visa|n. 签证
traffic|n. 交通；流量；非法交易；v. 非法买卖
airline|n. 航空公司
airplane|n. 飞机
helicopter|n. 直升机
jet|n. 射流；气流；喷射口；喷气式飞机；v. 喷射
parachute|n. 降落伞；v. 跳伞；用降落伞空投
flight|n. 飞行；航班；鸟群；（阶梯的）一段
pilot|n. 飞行员；驾驶员
passenger|n. 旅客；乘客
baggage|n. 行李
luggage|n. 行李
suitcase|n. 手提箱
carry-on|n. 手提行李；adj. 手提的
rack|n. 架子；支架；齿条；破坏；v. 折磨；使痛苦；放在架上；累计（得分）
freight|n. 货运；货物；运费；v. 运送
fare|n. 车费；票价；费用；v. 进展；成功（或不成功等）
atlas|n. 地图册；地图集
route|n. 路线；途径
itinerary|n. 路线；旅程
passage|n. 通过；通道；段落；短文
intersection|n. 交叉；相交；十字路口；交叉路口
cross|v. 穿过；交叉；横过；n. 十字架；十字形记号；adj. 恼怒的；生气的
way|n. 道路；方向；路线；方法；方式
path|n. 道路；小路；小径
lane|n. 小路；小巷；航道；车道；航线
avenue|n. 大街；林荫道；途径
highway|n. 公路
curb|v. 勒住；抑制；n. 抑制；约束；路缘；勒马绳
signpost|n. 路标
pave|v. 铺路；铺设
vehicle|n. 车辆；交通工具；媒介物；传达手段
auto|n. 汽车（auto- 作为前Ð的时候表示“自动的”、“自己的”）
express|v. 表达；表示；n. 特快列车；快件服务；adj. 明确的
tram|n. 电车；缆车；v. 乘电车；乘缆车
coach|n. 教练；长途客运汽车；火车车厢；v. 训练；培训
ambulance|n. 救护车
truck|n. 卡车；手推车；敞篷货车；v. 用卡车运；交易；交往
lorry|n. 卡车；载重汽车
van|n. 厢式货车
wagon|n. 四轮运货马车；敞篷货车
carriage|n. 四轮马车；运输；举止；仪态
tractor|n. 拖拉机；牵引机
cart|n. 大车；手推车
pedicab|n. 人力三轮车
cycle|n. 循环；周期；自行车；v. 循环；骑自行车
garage|n. 车库；汽车修理厂
motor|n. 马达；发动机；机动车
horsepower|n. 马力
wheel|n. 车轮；v. 转动
brake|n. 刹车；制动器；v. 刹车
tyre|n. 轮胎
honk|n. 雁叫声；汽车喇叭声；v. （使汽车喇叭）鸣响；（雁）叫
crew|n. 全体船员；全体人员
captain|n. 队长；船长；v. 指挥
steward|n. 乘务员；管家；保护者
emergency|n. 紧急情况
wreck|v. 破坏；毁坏；n. 遇难船只；失事；残骸
crash|v. 碰撞；坠毁；崩溃；n. 碰撞；坠毁；崩溃
crush|v. 挤压；压碎；碾碎；弄皱；镇压；n. 迷恋；拥挤的人群
dash|n. 短跑；猛冲；破折号；少量；v. 猛冲；急奔
vanish|v. 销声匿迹；突然消失
disappear|v. 消失；不见
hazard|n. 危害；危险；v. 冒险；使遭受危险
harbour|n. 海港；v. 庇护；窝藏
dock|n. 码头；被告席；v. 停靠码头；扣除（部分工资等）
anchor|n. 锚；靠山；台柱子；v. 抛锚；使稳固；主持节目
submerge|v. 潜水；浸没
sailor|n. 水手；海员
seaman|n. 海员；水兵；水手
carrier|n. 病毒携带者；运输公司；运输工具
steamer|n. 汽船；轮船
liner|n. 邮轮；客轮；衬里
vessel|n. 器皿；容器；船；血管
ferry|n. 渡船；渡口；v. 摆渡；运送
sail|v. 航行；驾（船）；n. 帆；航行；航海
raft|n. 木筏；木排；v. 筏运；乘筏
canoe|n. 独木舟
oar|n. 桨；橹；船桨
deck|n. 甲板；舱面
turbine|n. 涡轮
propeller|n. 螺旋桨；推进器
stern|adj. 严厉的，严格的；苛刻的；n. 船尾
aboard|adv. 在（船、车、飞机）上；prep. 在（船、车、飞机）上
embark|v. （使）上船或飞机；（使）从事
channel|n. 河床；海峡；（水）槽；渠道；频道；途径；v. 引导；开导；形成河道
canal|n. 运河；沟渠
ditch|n. 沟；渠；v. 开沟于；把…开入沟里；摆脱；抛弃；紧急降落
railroad|n. 铁路；v. 由铁路运输；迫使
railway|n. 铁路
locomotive|n. 机车；火车头；adj. 运动的
subway|n. 地铁；地下通道
underground|n. 地下；地铁；adj. 地下的；秘密的；adv. 在地下；秘密地
tunnel|n. 隧道；地道；v. 开凿隧道
rail|n. 横杆；铁轨；v. 咒骂；责备；抱怨；以横木围栏
depart|v. 离开；背离；离（职）；去世
arrive|v. 到达；抵达
destination|n. 目的地；终点
delay|v. 推迟；延缓；耽搁；n. 推迟；延缓；耽搁
postpone|v. 延期；延迟
defer|v. 推迟；延缓；服从
lull|v. 使镇静；使安静；哄骗；麻痹；n. 间歇期；平静期
expire|v. 终止；期满；断气；死亡
due|adj. 预期的；应给的；到期的
postage|n. 邮资；邮费
stamp|n. 邮票；印记；跺脚；v. 盖印；跺脚
mail|n. 邮件；v. 邮寄
packet|n. 小包；小盒
package|n. 包；包裹；v. 包装
bind|v. 捆绑；约束；装订；n. （非正式）窘境
parcel|n. 包裹；小包；v. 捆扎；打包
load|n. 负荷；载重；v. 承载；载入
burden|n. 负担；重担；责任；v. 使负重；烦扰
transfer|v. 转移；转让；调任；n. 转移；转让；调任
transmit|v. 发送；传播；传递
transit|n. 运输；中转；运送；v. 通过；经过；中转
deliver|v. 交付；递送；为…接生；发表；陈述；予以
convey|v. 传达；表达；运送；输送
speed|n. 速度；速率；v. 加速；加快
velocity|n. 速度；速率；迅速
swift|adj. 快的；迅速的；敏捷的；n. 雨燕
republic|n. 共和国；共和政体
Marxism|n. 马克思主义
socialism|n. 社会主义
communism|n. 共产主义
regime|n. 政权；管理制度
government|n. 政府；治理；统治
authority|n. 权威；权威人士；权力；当局；官方机构
political|adj. 政治的；政权的
hierarchy|n. 层次体系；等级制度
democracy|n. 民主
bureaucracy|n. 官僚主义；官僚机构
egalitarian|adj. 平等主义的；n. 平等主义
materialism|n. 唯物主义；唯物论；实利主义
revolution|n. 革命
reform|n. 改革；改造；v. 改革；改造
process|n. 过程；进程；工序；v. 处理；加工
conservative|adj. 保守的；守旧的；n. 守旧派；保守主义者
meltdown|n. 熔化；熔毁；彻底垮台
municipal|adj. 市的；市政的
neutral|adj. 中立的；非彩色的；中性的；n. 中立者；素净色；空挡位置
bilateral|adj. 两边的；双方的
arena|n. 竞技场；舞台
flag|n. 旗；旗帜；信号旗；v. 用旗标记；无力地下垂；减退；枯萎
banner|n. 旗帜；横幅
president|n. 总统；总裁；主持人；校长；行长
premier|n. 总理；首相；adj. 第一的；首要的
minister|n. 部长；大臣；牧师
secretary|n. 秘书；大臣
parliament|n. 国会；议会
senate|n. 参议院
conference|n. 大型会议；商讨
meeting|n. 会议；会面；v. 遇见；见面；满足；“meet”的现在分词
headquarters|n. 总部；司令部；指挥部
delegation|n. 代表（团）；委派；授权
behalf|n. 代表；利益；支持
police|n. 警方；警察部门；v. 维持治安；管理；监督
statesman|n. 政治家
mayor|n. 市长
service|n. 服务；v. 保养；维修
office|n. 办公室
bureau|n. 局；办事处
department|n. 部门；系；部
administration|n. 管理；行政
dominate|v. 统治；支配；俯瞰
power|n. 权力；力量；电源；强国；乘方；幂；v. 给…提供能量；供以动力
influence|n. 影响（力）；有影响的人或物；v. 影响
affect|v. 影响；感动；假装
importance|n. 重要性；重要
significance|n. 意义；重要性
organisation|n. 机构；组织；安排，筹备
association|n. 协会；联系；联想
union|n. 联盟；联合；工会
community|n. 社区；团体；群落
consortium|n. 财团；协会
league|n. 联盟；同盟；v. （使）结盟
institution|n. 机构；风俗；制度；制定
unite|v. 联合；团结；统一
unique|adj. 唯一的；独特的
nation|n. 国家；民族
global|adj. 全球的
worldwide|adj. 全球性的；adv. 全球性地
federal|adj. 联邦的；联邦制的；联邦政府的
foreign|adj. 外国的；外来的
overseas|adj. 外国的；海外的；adv. 在国外；在海外
abroad|adv. 在国外；出国
civil|adj. 公民的；国内的；民用的；文明的
emigrate|v. 移居国外
immigrate|v. 移居入境
reign|v. 统治；支配；盛行；n. 君主统治；在位期
puppet|n. 木偶；傀儡
throne|n. 王位；宝座
crown|n. 皇冠；王冠；v. 加冕；加顶；使圆满
wreath|n. 花圈；花环；圈状物；环状物
colony|n. 殖民地；群体
liberty|n. 自由
independence|n. 独立；自主
slum|n. 贫民窟；贫民区
refuge|n. 避难所；庇护
asylum|n. 收容所；避难所；精神病院；（政治）庇护
population|n. 人口
demographic|adj. 人口统计的；人口的
citizen|n. 公民；市民
resident|n. 常住居民；adj. 居住的；常驻的
ethnic|adj. 种族的；民族的；n. 少数民族的一员
racial|adj. 种族的
clan|n. 氏族；宗族
franchise|n. 特许经营权；获特许经营权的商店；v. 授予…特许经销权；向…出售特许经销权
entitle|v. 授权；命名；给...权利（或资格）
preference|n. 偏爱；偏好；优先；优惠
vote|n. 选票；表决；得票数；v. 投票；选举
elect|v. 选举；选择
respondent|n. 回答者；被告；adj. 回答的；有反应的
poll|n. 民意调查；v. 获得（选票）；做民意调查
ambition|n. 野心；雄心；抱负
nominate|v. 提名；推荐；指派
checklist|n. 清单；检查表；备忘录；目录册
succession|n. 一连串；连续；更迭；继承
safety|n. 安全；平安
welfare|n. 福利；社会救济
well-being|n. 幸福；安乐；康乐
harmony|n. 和谐；协调
steady|adj. 稳定的
flourish|v. 茁壮成长；繁荣兴旺；挥动；n. 夸张动作
succeed|v. 成功；继承
prospect|n. 展望；前景；希望；v. 勘探；寻找
perspective|n. 视角；观点；（对事物的）合理判断；透视；（远）景
viewpoint|n. 观点；看法
standpoint|n. 立场；观点
outlook|n. 景色；前景；观点；人生观
guideline|n. 指导路线；方针
ethic|n. 道德规范；伦理标准
suggest|v. 建议；提出；使想起；暗示
advise|v. 向…提出建议；劝告；通知
proposal|n. 建议；提案；求婚
hint|n. 暗示；提示；有益的建议；v. 暗示；提示
declare|v. 宣布；宣告；断言；申报纳税
affirm|v. 断言；肯定；证实
claim|n. 声称；索要；要求；认领；v. 声称；要求；索赔
proclaim|v. 宣告；公布；表明
state|n. 情形；状态；国家；州；v. 说明；陈述；声明；规定；adj. 国事礼仪（或规格）的；州的；邦的
announce|v. 宣布；宣称
clarify|v. 澄清；阐明
assist|v. 帮助；援助；协助
aid|v. 帮助；协助；n. 帮助；援助
encourage|v. 鼓励；鼓舞；促进；鼓动
implement|v. 实施；执行；n. 工具；器具
monitor|n. 监视器；班长；显示器；v. 监控；监视
admit|v. 承认；允许进入
African|adj. 非洲的；非洲人的；n. 非洲人
European|adj. 欧洲的；欧洲人的；欧盟的；n. 欧洲人
Latin|n. 拉丁语；adj. 拉丁语的；拉丁语系国家的
Jewish|adj. 犹太人的；有关犹太人的；犹太教的
Arabian|adj. 阿拉伯（人）的；n. 阿拉伯人
Portuguese|adj. 葡萄牙的；葡萄牙人的；葡萄牙语的；n. 葡萄牙人；葡萄牙语
Roman|adj. 古罗马的；罗马人的；n. 罗马；古罗马人
Russian|n. 俄罗斯人；俄语；adj. 俄国的；俄国人的；俄语的
Spanish|adj. 西班牙的；西班牙人的；西班牙语的；n. 西班牙语
Swiss|n. 瑞士人；法语或意大利语等；adj. 瑞士的；瑞士人的
Greek|adj. 希腊的；希腊人的；希腊语的；n. 希腊人；希腊语
Italian|n. 意大利语；意大利人；adj. 意大利的；意大利人的；意大利语的
soviet|adj. 苏联的；n. 苏联人；苏维埃
Indian|adj. 印度的；印第安人的；n. 印度人；印第安人
Australia|n. 澳大利亚；澳洲
New Zealand|n. 新西兰（太平洋南部岛国）
Canada|n. 加拿大
Britain|n. 英国；不列颠
France|n. 法国
Germany|n. 德国
economy|n. 经济；节约
trade|n. 贸易；交易；行业；v. 贸易；交易
market|n. 市场；商场；销路；行情；v. 在市场上交易；营销
industry|n. 工业；产业；行业；勤奋
merchant|n. 商人
financial|adj. 财政的；金融的
fund|n. 基金；资金；v. 提供资金
donate|v. 捐赠；捐献
endow|v. 捐赠；资助；赋予
commercial|adj. 贸易的；商业的；n. 广告
advertise|v. 做广告；登广告
slogan|n. 口号；标语
purchase|n. 购买；采购；v. 购买；采购
lease|n. 租契；v. 出租
afford|v. 买得起；担负得起；有时间做；给予
retail|v. 零售；n. 零售
grocery|n. 食品杂货店
discount|n. 折扣；贴现率；v. 打折扣；贴现；不全信；不重视
promotion|n. 促进；提升；推广
voucher|n. 代金券；凭单
coupon|n. 优惠券；息票；配给券
currency|n. 货币；流通
exchange|n. 交换；交易所；兑换；v. 交换；兑换
swap|v. 交换；n. 交换
receipt|n. 收据；收条
invoice|n. 发票；发货单；v. 开发票；记清单
tax|n. 税；税款；v. 对...征税；使负重荷
levy|v. 征收；征税；征募；n. 征兵；征税
tariff|n. 关税；税率；（旅馆、饭店等的）价目表
duty|n. 责任；职责；义务
impose|v. 强加；征收；施加影响；利用；强制实施
consume|v. 消耗；消费；毁掉；（使）沉溺；（使）沉迷；（使）充满
spend|v. 花费；消耗；度过
cost|v. 花费；n. 费用；代价
expense|n. 费用；开支
revenue|n. 收入；税收
gross|adj. 总的；严重的；过分的
recession|n. 后退；（经济）不景气
depression|n. 抑郁；沮丧；萧条；凹陷；洼地；低气压区
crisis|n. 危机；危急关头
security|n. 安全；防护措施；保障；担保；抵押品
bond|n. 纽带；联系；债券；保释金；协定；v. （使）黏合；相互联结
debt|n. 债务；欠款
deficit|n. 不足额；赤字；亏损
inflation|n. 膨胀；充气；通货膨胀
deflation|n. 通货紧缩；放气
dwindle|v. 缩小；减少
decrease|v. 减少；降低；n. 减少
downsize|v. 缩小（规模）；裁员
decline|v. 下降；衰退；谢绝；婉拒；n. 下降；衰退；婉拒
diminish|v. 减少；削弱；减损；贬低
reduce|v. 减少；降低；减量
increase|n. 增加；增长；v. 增加；增多
increment|n. 增加；增量
growth|n. 生长；增长
escalate|v. （使）升级；（使）恶化；逐步升高
expand|v. 扩大；膨胀；更充分地阐述
influx|n. 流入；涌入
affluent|adj. 富裕的；丰富的；富足的
enrich|v. 使富裕；使富足
sufficient|adj. 足够的；充足的
adequate|adj. 足够的；尚可的
spare|adj. 多余的；空闲的；备用的；瘦削的；简陋的；v. 节省；抽出；分让；宽恕；使免遭
saving|n. 节约；v. 保存；拯救；节省；“save”的现在分词
redundant|adj. 多余的；过剩的；被裁减的
lack|v. 缺乏；短缺；n. 缺乏；短缺
company|n. 公司；陪伴
firm|n. 公司；商行；adj. 坚固的；结实的
enterprise|n. 事业；企业；进取心
agent|n. 代理人；经纪人；动因；特工；（药）剂
entity|n. 独立存在体；实体
invest|v. 投资；投入
input|n. 输入；v. 输入
product|n. 产品；产物；成果；〈数〉积
acquisition|n. 获得；得到的东西；收购
goods|n. 商品；货物
cargo|n. 货物
insure|v. 保险；确保
guarantee|v. 保证；确保；n. 保证；保证书
reliable|adj. 可靠的；可信的
negotiation|n. 谈判；协商；磋商
attend|v. 出席；参加；照料；注意；专心
absent|adj. 缺席的；v. 缺席；不参加
sale|n. 销售；出售；减价销售
wholesale|n. 成批出售；adj. 批发的；大规模的；adv. 大批地；大规模地；v. 批发售出
auction|n. 拍卖；v. 拍卖
bid|v. 出价；投标；吩咐；向某人道（午安等）；n. 出价；投标；努力争取
deal|n. 交易；协议；v. 处理；对付；交易
transaction|n. 交易；业务
turnover|n. 营业额；周转率；人员流动率
dump|v. 倒空；n. 垃圾场
export|v. 输出；出口；n. 输出；出口
import|v. 进口；输入；n. 进口；输入；重要性；含义
quota|n. 配额；限额；定额
share|v. 共享；分享；n. 分享；股份
benefit|n. 利益；好处；救济金；v. 有益于；有助于
interest|n. 兴趣；利益；利息；v. 使产生兴趣
stock|n. 库存；股票；家畜；v. 备有；贮存
account|n. 账户；叙述；账目；v. 说明；占…
deposit|n. 存款；押金；沉淀；v. 存储；堆积
instalment|n. 部分；分期付款；分期连载的一部分
cheque|n. 支票
cash|n. 现金
coin|n. 硬币；金属钱币；v. 铸造硬币；杜撰；创造
shilling|n. 先令（英国1971年以前的辅币，等于12便士）
copper|n. 铜；铜币
treasure|n. 财富；珍宝；宝物；v. 珍爱；珍惜；珍藏
wealth|n. 财富；财产
estate|n. 庄园；个人全部财产（遗产）；地产
possess|v. 拥有；占有
legacy|n. 遗产；遗赠
descend|v. 下降；突然造访；突袭；沦落；起源
worthy|adj. 值得尊敬的；值得…的
valuable|adj. 有价值的；贵重的；值钱的
cheap|adj. 便宜的；廉价的
incentive|n. 刺激；诱因；动机
accelerate|v. 加速；加快
prompt|adj. 迅速的；准时的；v. 提示；促使；n. 提示；提词
salary|n. 薪金
income|n. 收入；收益；所得
wage|n. 工资；v. 发动
payment|n. 支付；报酬
refund|v. 退还；偿还；n. 退款；返还款
reimburse|v. 偿还；报销
payroll|n. 职工工资册；工薪总额
remuneration|n. 报酬；酬金
subsidy|n. 补贴；津贴；补助金
earn|v. 获得；赚得
undertaking|n. 事业；企业；承诺；保证；v. 承担；从事；保证；“undertake”的现在分词
career|n. 事业；生涯
profession|n. 职业；专业
occupation|n. 占领；占有；职业；消遣
job|n. 工作
vocation|n. 职业；行业；使命
labour|n. 劳动；体力劳动；劳工；分娩；v. 辛勤工作；分娩
workforce|n. 劳动力；工人总数；职工总数
workaholic|n. 工作狂
personnel|n. 职员；全体人员；人事部
clerk|n. 职员；店员
interview|n. 面试；访谈；v. 面试；接见
résumé|n. 简历；履历
recommend|v. 建议；推荐
employ|v. 雇佣；使用
hire|v. 雇用；租用
fire|n. 火；炮火；热情；激情；v. 射击；开火；解雇；激发
lay-off|n. 解雇；失业期；停工期
dismiss|v. 解雇；解散；摒除；不理会；（法律）驳回
discharge|v. 放出；排出；开除；偿还债务；履行；卸货；放电；n. 排放；排放出的物体
resign|v. 辞职；使…顺从于（做）某事
sack|n. 袋子；解雇；v. 解雇；装入袋子；劫掠
retire|v. 退休；退役
result|n. 结果；成败；成效；比分；v. 由于；导致
failure|n. 失败
abortion|n. 流产；堕胎
loss|n. 损失；丢失；亏损
opportunity|n. 机会；时机
chance|n. 机会；可能性；冒险
choose|v. 选择
change|n. 变化；变革；零钱；v. 变化；变革
solve|v. 解决；解答
develop|v. 发展；形成；制订
sustainable|adj. 可以忍受的；可支撑的；可持续的
improve|v. 改善；改进；提高
manage|v. 管理；设法做到；完成（困难的事）
regulate|v. 管制；调整
sanction|n. 批准；允许；认可；制裁；处罚；v. 批准；认可；制裁；处罚
coordinate|v. 协调；使配合；搭配；n. 坐标；adj. （在句子中）并列的；坐标的
cooperate|v. 合作；协作
collaborate|v. 合作；协作；通敌
law|n. 法律；定律
legal|adj. 合法的；法律的
rule|n. 规则；统治；v. 统治；支配；裁决
regulation|n. 规则；条例；管理
treaty|n. 条约；协议
agreement|n. 一致；同意；协议
charter|n. 宪章；许可证；包租；v. 包租（汽车、飞机等）；特许
protocol|n. 外交礼节；礼仪；（外交）议定书；协议
norm|n. 准则；标准
benchmark|n. 基准点
criteria|n. 标准；尺度；准则；“criterion”的复数
standard|n. 标准；adj. 标准的；规范的；权威的
allow|v. 允许；准许；给予；留出；同意；承认
admission|n. 允许进入；承认
enforce|v. 强制执行；强加
default|v. 拖欠；违约；n. 拖欠；违约；默认
reject|v. 拒绝；驳回；n. 被拒之人；被弃之物；残次品
constraint|n. 约束；限制；拘束
official|n. 官员；高级职员；adj. 官方的；正式的
mandatory|adj. 强制的；法定的；义务的
potent|adj. 强有力的；有效的
bound|adj. 一定会；有义务的；密切相关的；准备前往；v. 受…限制；v. 捆绑；“bind”的过去式和过去分词
obligation|n. 义务；责任
court|n. 法院；球场；宫廷；v. 求爱；献殷勤；招致
supreme|adj. 至上的；¸高的
enact|v. 制定（法律）；通过（法律）；扮演（角色）
legislate|v. 制定法律；用立法规定
equity|n. 公正；股票
fair|adj. 公平的；合理的；相当大的；n. 交易会；展销会；集市
just|adv. 只是；就；仅仅；刚刚；恰好；adj. 公正的；正当的；合理的
prejudice|n. 偏见；成见；v. 使有偏见；损害
discrimination|n. 区别；辨别；歧视
accuse|v. 指控；指责
sue|v. 起诉；控告；请求
prosecute|v. 起诉；控告；检举；指控；继续从事
condemn|v. 谴责；判刑
complain|v. 抱怨；投诉
boycott|v. 抵制；拒绝参加；n. 抵制；拒绝参加
session|n. 会议；会期；开庭；学期；一段时间
mediate|v. 调停；斡旋
plea|n. 恳求；申诉；抗辩；借口
appeal|n. 恳求；呼吁；上诉；吸引力；v. 呼吁；吸引；诉请
contradict|v. 反驳；相矛盾
persuade|v. 说服；劝说
controversy|n. 争论；论战
whisper|v. 耳语；低语；n. 耳语；低语；飒飒的声音
mutter|v. 咕哝地抱怨；嘀咕；n. 咕哝地抱怨；嘀咕
murmur|n. 低语声；嘟哝；v. 低语；咕哝；私下抱怨
silent|adj. 沉默的；无声的
mute|adj. 哑的；无声的；n. 哑巴；沉默的人；v. 减弱…的声音；adv. 缄默地
investigate|v. 调查；研究
witness|n. 证人；目击者；v. 见证
justify|v. 替...辩护；证明...正当
reasonable|adj. 合理的
suitable|adj. 合适的；适宜的
judge|n. 法官；裁判；v. 判断；评判；审判
jury|n. 陪审团；评委会
trial|n. 审判；试验；考验；v. 测试
suspect|v. 猜想；怀疑；n. 嫌疑犯；adj. 令人怀疑的；不可信的
sentence|n. 句子；判决；宣判；v. 判决；判刑
arrest|v. 逮捕；拘留；阻止；吸引；n. 逮捕；拘捕
jail|n. 监狱
prison|n. 监狱；监禁
confine|v. 限制；监禁
oversee|v. 监督；监视
supervise|v. 监督；管理；指导
restrict|v. 限制；约束
restrain|v. 抑制；抑止
commit|v. 犯（罪、错）；承诺；投入
sin|n. 罪；罪行
crime|n. 罪行；罪恶
vice|n. 恶习；罪恶；缺点；代理；副职；adj. 代理的；副职的
bribe|v. 贿赂；n. 贿赂
rob|v. 抢劫；掠夺
pirate|n. 海盗；盗版者；v. 抢劫；剽窃；盗印
steal|v. 偷；窃取
thief|n. 小偷；贼；窃贼
murder|n. 谋杀；v. 谋杀；杀害
suicide|n. 自杀
deceive|v. 欺骗；蒙骗
cheat|n. 骗子；作弊者；v. 欺骗；作弊
fraud|n. 欺骗；欺诈；骗子；伪品
liar|n. 说谎者；骗子
trap|n. 圈套；陷阱；困境；v. 设圈套；陷入（困境）
trick|n. 戏法；诡计；恶作剧；诀窍；v. 哄骗；欺骗
pretend|v. 假装；佯装；自称
fool|n. 傻瓜；蠢人；v. 愚弄
stigma|n. 耻辱；污名；（花朵的）柱头
confess|v. 承认；忏悔
conform|v. 符合；顺应；遵从；（使）一致
reconcile|v. 使和解；使和好；调和
obey|v. 遵守；服从
succumb|v. 屈服；屈从
penalty|n. 惩罚；刑罚
fine|adj. 很好的；晴朗的；健康的；adv. 很好；n. 罚款；v. 罚款
mortgage|n. 抵押；按揭；v. 抵押；按揭
ownership|n. 所有权；物主身份
copyright|n. 版权；著作权
privilege|n. 特权；荣幸；v. 给予特权；特殊对待
accredit|v. 归于；委托；授权；信任
clue|n. 线索；提示
access|n. 进入；通道；接触（的机会或权利）；v. 接近；使用；获取
anonymous|adj. 匿名的；无名的；不知名的
false|adj. 虚假的；错误的
genuine|adj. 真正的；真诚的
procedure|n. 程序；手续；步骤
routine|n. 常规；例行公事；adj. 常规的；例行公事的
consequence|n. 后果；结果
demand|n. 要求；请求；需求；v. 要求；请求；需求
request|n. 请求；要求的事；v. 要求；请求
require|v. 需要；要求
petition|v. 请求；请愿；祈求；n. 请愿书；祈求；诉状
command|n. 命令；指挥；掌握；v. 命令；指挥；掌握
instruct|v. 教授；教导；指示；命令；通知
violence|n. 暴力；暴行
conflict|n. 冲突；矛盾；v. 抵触；冲突
raid|n. 袭击；突击；劫掠；v. 突袭；搜捕；劫掠
enormity|n. 极恶；庞大；巨大
campaign|n. 战役；运动；（政治、商业或社会性）活动；v. 参加战役；从事活动
battle|n. 战斗；v. 战斗
struggle|v. 斗争；挣扎；抗争；n. 斗争；奋斗；抗争
explosion|n. 爆炸；（感情）爆发；激增
bombard|v. 炮轰；轰击
bomb|n. 炸弹；v. 投弹于；轰炸
blast|n. 爆炸；一阵强劲的气流；突然的响声；v. 爆破；产生巨大噪声
burst|v. 爆裂；突然而起；n. 爆裂；突然而起
spark|n. 火花；火星；v. 触发；冒火花；闪光；激发
twinkle|v. 闪耀；闪烁；n. 闪烁
gunpowder|n. 火药；有烟火药
tank|n. 罐；箱；坦克；v. 把 ... 储于槽中
cannon|n. 大炮；火炮；v. 猛撞；碰撞
missile|n. 导弹
weapon|n. 武器
pistol|n. 手枪
rifle|n. 步枪；来复枪；v. 快速搜寻
bullet|n. 子弹；枪弹
target|n. 目标；对象；靶；v. 以…为目标；瞄准
deflect|v. 偏斜；偏离；使转向；使中止
mission|n. 使命；任务；使团
flame|n. 火焰；v. 燃烧；爆发；面红
flare|v. （突然）烧旺；闪耀；突然爆发；张开；加剧；n. 旺火；亮光
glitter|n. 闪耀；闪烁；小发光物；v. 闪耀；闪亮；流露（感情）
glow|v. 发光；发热；脸红；n. 红光；炽热；脸红；喜悦
blade|n. £刃；桨叶
sword|n. 剑；£
ax|n. 斧子；v. 用斧砍；裁减；大量削减
hammer|n. 锤子；v. 锤打
arrow|n. 箭；箭头
spear|n. 矛；枪；v. 用矛刺
helmet|n. 头盔；防护帽
shield|n. 盾牌；防护物；v. 遮挡；防护
equip|v. 装备；配备
prepare|v. 准备；预备
provide|v. 提供；供应
deploy|v. 部署；有效地利用
hit|v. 打；击；碰撞；袭击；抨击；达到；n. 打；击；碰撞；袭击；（演出等）成功
beat|v. 打；敲打；击败；n. 一击；跳动
strike|v. 击打；罢工；侵袭；突然想到；划（火柴）；n. 罢工；袭击
punch|n. 重拳击打；v. 拳打；打孔
chop|v. 砍；劈；剁；n. 砍；剁；排骨
stab|n. 刺；戳；v. 刺；戳
dilemma|n. （进退两难的）窘境
plight|n. 境况；困境；v. 保证；发誓
pitfall|n. 陷阱；隐患；想不到的困难
conspiracy|n. 阴谋
destitute|adj. 赤贫的；贫困的；一无所有的
famine|n. 饥荒
starve|v. 挨饿；饿死
deprive|v. 剥夺；使丧失
seize|v. 抓住；捉拿；夺取
pursue|v. 追求；追赶；追逐
threat|n. 威胁；恐吓；凶兆
offend|v. 冒犯；得罪；违反；犯罪
aggressive|adj. 侵略性的； 攻击性的；有进取心的
invade|v. 侵犯；侵略
trespass|v. 非法侵入；侵扰；冒犯；n. 非法进入；冒犯
intrude|v. 闯入；打扰；强使
violate|v. 违反；侵犯
attack|v. 攻击；袭击；n. 攻击；袭击
assault|n. 攻击；袭击；侵犯他人身体（罪）；v. 袭击；突袭
challenge|n. 挑战；盘问；质疑；怀疑；v. 提出挑战；质疑；驳斥
siege|n. 围攻；封锁
surround|v. 环绕；围绕
enclose|v. 围起；附上；封入
pause|v. 暂停；停顿；n. 暂停；停顿
halt|n. 停顿下来；v. 暂停；中断
cease|v. 停；息；停止
oppose|v. 反对；反抗
oppress|v. 压迫；使烦恼
counter|n. 柜台；对立面；v. 反驳；抵消；adv. 相反地
deter|v. 制止；威慑；使不敢
forbid|v. 禁止；不准
prohibit|v. 禁止；妨碍
prevent|v. 防止；预防；妨碍
revolt|v. 叛乱；反叛；（使）厌恶；n. 叛乱；厌恶；反感
betray|v. 背叛；出卖；泄露；暴露
treason|n. 叛国（罪）；卖国（罪）
rebel|v. 反抗；造反；n. 叛逆者；造反者
traitor|n. 叛徒；背叛者；卖国贼
patriot|n. 爱国者
blame|v. 责怪；归咎于；指责；n. 责备；责任；指责
reproach|v. 责备；指责；n. 责备；指责
evidence|n. 证据；证明
proof|n. 证明；证据；检验；adj. 防…的
terror|n. 恐怖；恐惧
terrible|adj. 可怕的；极坏的；糟糕的
terrific|adj. 极好的；大得惊人的
horrible|adj. 恐怖的；可怕的
alarm|n. 警报；警铃；闹钟；惊慌；v. 使惊恐
dread|v. 害怕；畏惧；n. 恐惧；畏惧
frighten|v. 使惊吓；使惊恐
tension|n. 紧张；紧张局势；紧张关系
turbulent|adj. 狂暴的；骚动的；动荡的；汹涌的
turmoil|n. 混乱；动荡；骚乱；恐慌
scenario|n. 设想；可能发生的情况；情节梗概
occasion|n. 特殊场合；时机；机会；理由；需要；v. 导致；使发生
limit|n. 限制；v. 限制
boundary|n. 分界线；边界
rein|n. 缰绳；驾驭；控制；v. 控制；驾驭
compete|v. 竞争；比赛
contest|n. 比赛；竞赛；v. 竞争；争夺；争辩；辩驳
contend|v. 声称；主张；竞争；争辩
rival|n. 竞争者；敌手；v. 竞争；相匹敌
competitor|n. 竞争者
enemy|n. 敌人；敌军
strategy|n. 策略；战略
tactic|n. 战术；策略
manoeuvre|n. （熟练地）移动；巧计；v. 控制；移动；操控
blueprint|n. 蓝图；计划；设想；v. 为…制蓝图；为…制订计划
warn|v. 警告；告诫；提醒注意
compel|v. 强迫；胁迫
oblige|v. 迫使；效劳
protest|n. 抗议；抗议活动；v. 抗议
refute|v. 驳斥；反驳；批驳
might|v. 可能；也许；应该；“may”的过去式；n. 威力；强大力量
force|n. 力；力量；武力；兵力；v. 强迫；促使；推动
reinforce|v. 增强；增援；加强；加固
impair|v. 损害；削弱
mitigate|v. 减轻；缓和
comfort|n. 舒服；安逸；安慰；v. 安慰
event|n. 事件；大事；比赛项目
matter|n. 事情；物质；问题；麻烦；v. 要紧
happen|v. 发生
occur|v. 发生；出现
savage|adj. 野性的；凶猛的；荒野的；n. 野蛮人；粗人；凶恶的人；v. 凶狠地攻击；激烈抨击
reckless|adj. 鲁莽的；不计后果的
fierce|adj. 凶猛的；凶狠的
foul|adj. 肮脏恶臭的；很令人不快的；很坏的；v. 使污秽；对…犯规；缠结难解；n. 犯规
evil|n. 邪恶；罪恶；adj. 恶毒的
devil|n. 魔鬼；恶魔
punishment|n. 处罚；惩罚
execute|v. 执行；实施；处死
hang|v. 悬挂；吊；绞死；n. 悬挂；绞刑
sacrifice|v. 牺牲；献出；供奉；n. 供奉；祭品；牺牲（品）
casualty|n. 伤亡（人数）；受伤的人；事故；临时救治所；急诊室
bury|v. 埋葬；埋藏
funeral|n. 葬礼
grave|n. 坟墓；adj. 严重的；重大的；严肃的；沉重的
tomb|n. 坟墓；冢；v. 埋葬
hell|n. 地狱；苦境
maritime|adj. 海的；海事的；海运的
naval|adj. 海军的
fleet|n. 舰队；船队；机群；adj. 快速的；v. 掠过；疾飞
troop|n. 军队（复）；部队（复）；连；队；群；v. 群集；结队；成群前行
landing|n. 着陆；降落；楼梯平台；v. 降落；着陆；“land”的现在分词
hover|v. 盘旋；翱翔；徘徊
proceed|v. 进行；继续；继续进行
progress|n. 进展；进步；缓慢前进；稳步前进；v. 进展；进步；（时间）逐渐过去；前进
military|adj. 军事的；军用的；n. 军队；武装力量
nuclear|adj. 原子能的；核能的
poison|n. 毒药；毒物；v. 毒害；下毒
devastate|v. 毁灭；摧毁；变成废墟
risk|n. 风险；v. 冒...的危险
adventure|n. 冒险；奇遇；v. 冒险
peril|n. 危险；冒险；v. 置…于危险中；危及
catastrophe|n. 灾难
collapse|v. 倒塌；昏倒；暴跌；折叠；n. 倒塌；崩溃；病倒；暴跌
torture|n. 酷刑；拷打；v. 拷打；折磨
humiliate|v. 使屈辱；使丢脸；使蒙羞
damage|v. 损害；破坏；n. 损害；破损
harmful|adj. 有害的
mislead|v. 误导
disturb|v. 打扰；妨碍
interfere|v. 干涉；干预；干扰
interrupt|v. 打断；打扰；打岔
retreat|v. 撤退；退却；n. 撤退；退却；静居处
shrink|v. 收缩；退缩；踌躇不前
withdraw|v. 撤回；撤退；提取
withstand|v. 抵挡；经受住
compromise|n. 妥协；和解；v. 妥协；和解；损害；危及
surrender|v. 投降
escape|v. 逃避；逃走；n. 逃脱；逃避
avoid|v. 避免；避开
quit|v. 停止；辞职； 离开
abandon|v. 抛弃；放弃；中止
forgo|v. 弃绝；摒绝
discard|v. 抛开；遗弃；废弃
rid|adj. 摆脱了的；v. 摆脱；除去
defend|v. 防守；防御；辩护
safeguard|n. 保护措施；v. 保卫；保护
defeat|v. 击败；战胜；使受挫；n. 失败；战胜
resist|v. 抵制；抵抗
capture|v. 逮捕；夺取；吸引；记录；准确地描述；n. 抓捕；攻占
victory|n. 胜利；成功
triumph|v. 战胜；成功；n. 胜利；凯旋
conquer|v. 征服；克服
monument|n. 纪念碑；历史遗迹；不朽作品
tablet|n. 药片；丸；（刻有文字的）匾；
statue|n. 雕像；雕塑
medal|n. 奖章；勋章
honour|n. 荣誉；荣幸；尊敬；v. 尊敬；给予荣誉
glorious|adj. 光荣的；辉煌的
contribute|v. 捐献；投稿；贡献；促成
devote|v. 投入；献身
owe|v. 欠；归功于；欠债
patrol|n. 巡逻；v. 巡逻
guard|n. 保卫；警卫；v. 守卫；警戒
camouflage|v. 伪装；掩饰；n. 伪装；掩饰
obstacle|n. 障碍
burrow|v. 挖洞；钻进；翻寻；n. 地洞
spy|n. 间谍；密探；v. 秘密侦察；发现
scout|v. 侦察；巡视；搜寻；物色；n. 侦察；侦察兵；物色人才的人；童子军
general|adj. 总的；普遍的；一般的；大致的；首席的；n. 将军
soldier|n. 士兵；军人
veteran|n. 老兵；老手；adj. 老练的
pioneer|n. 拓荒者；先驱者；创始者；倡导者；v. 开拓；做先锋；倡导
prophet|n. 预言者；先知
herald|n. 使者；传令官；v. 预报；标志
heir|n. 继承人；后嗣
successor|n. 接班人；继任人
generation|n. 代；辈；产生
surname|n. 姓
gender|n. 性别；（语法）性
sex|n. 性；性别；男性；女性；v. 区别 ... 性别；引起 ... 性欲
female|n. 女性；雌性；adj. 女性的；雌性的
couple|n. （一）对；几个；夫妻；v. 连合；连接；结合
spouse|n. 配偶
husband|n. 丈夫；v. 节俭使用
gay|adj. 同性恋的；愉快的；n. 同性恋者
grandfather|n. 祖父；爷爷
father-in-law|n. 岳父；公公
sibling|n. 兄弟姐妹
cousin|n. 堂兄弟（或姐妹）；表兄弟（或姐妹）
nephew|n. 侄子；外甥
niece|n. 侄女；外甥女
twin|n. 双胞胎之一；adj. 双胞胎的；成对的；同时出现的
embryo|n. 胚；胚胎
infant|n. 婴儿；幼儿；adj. 婴儿的；幼儿的；初期的
orphan|n. 孤儿；失去生母的幼小动物
juvenile|adj. 青少年的；幼稚的；n. 少年
youngster|n. 年轻人；小伙子
youth|n. 青春；年轻；青年
gang|n. 一群；一帮；一伙；v. 成群结队；结成一伙；合伙攻击
teenager|n. （十三到十九岁的）青少年
adolescence|n. 青春期
kin|n. 亲属；亲戚
folk|n. 人们；人民；民族；adj. 民间的；普通平民的
relative|n. 亲戚；adj. 比较的；相对的；相关联的
intimate|adj. 亲密的；私密的
dear|adj. 亲爱的；宝贵的；昂贵的；n. 亲爱的人；可爱的人
darling|n. 心爱的人；adj. 亲爱的
lover|n. 情人；爱人；爱好者
beloved|adj. 钟爱的；深爱的
madam|n. 夫人；女士；非常自我的女子
hostess|n. 女主人；女房东；女招待；女主持人
landlady|n. 女房东
mistress|n. 女主人；情妇；女教师（英）
housewife|n. 家庭主妇
widow|n. 寡妇；遗孀
maid|n. 女仆；少女
maiden|n. 少女；处女；未婚女子；adj. 初次的
household|n. 家庭；adj. 家庭的；家喻户晓的
chore|n. 家务活；杂事；令人讨厌的或繁重的工作
host|n. 主人；主持人；v. 主持
landlord|n. 地主；房东
tenant|n. 房客；租户；佃户
guest|n. 客人；宾客；v. 做客；做特邀嘉宾；做客串
customer|n. 客户；顾客；主顾
client|n. 客户；委托人；当事人
encounter|v. 遭遇；遇到；邂逅；n. 遭遇；遭遇战
chase|v. 追逐；n. 追逐
miss|v. 想念；错过；漏掉；n. 错过；女士；小姐
appointment|n. 约会；约定；职位；任命
accompany|v. 陪伴；伴随；为…伴奏
dependent|adj. 依靠的；依赖的；n. 依赖他人者；受赡养者；食客；寄人篱下的仆从
propose|v. 提议；计划；求婚；举荐
engagement|n. 订婚；约定；约会；交战；（与…的）密切关系
marry|v. 结婚；与…结婚；嫁（女）
wedding|n. 婚礼；婚宴
honeymoon|n. 蜜月
kiss|v. 亲吻；接吻；n. 吻
divorce|n. 离婚；脱离；v. 离婚；使脱离
separate|adj. 分开的；分离的；单独的；v. 分离；隔离
single|adj. 单一的；单独的；单身的；n. 单曲（唱片）；v. 挑选
sole|n. 鞋底；脚掌；adj. 仅有的；唯一的
respective|adj. 各自的；各个的
each|adj. 各自的；每个的；pron. 每个；各自
individual|n. 个人；adj. 单独的；个别的
commuter|n. 通勤者；经常往返者
neighbourhood|n. 街坊；四邻；街道；附近地区
member|n. 成员；会员
boss|n. 老板
manager|n. 经理；管理者
supervisor|n. 监督人；管理人；主管人
subordinate|adj. 次要的；附属的；n. 下属；从属物；v. 使居于次要
partner|n. 合伙人；搭档
colleague|n. 同事
comrade|n. 同志；伙伴
acquaintance|n. 认识的人；相识
friendship|n. 友谊；友情
affection|n. 钟爱；喜爱
stranger|n. 陌生人；外地人；新来者；adj. 奇怪的；陌生的；“strange”的比较级
apprentice|n. 学徒；徒弟；v. 使当学徒
deputy|n. 代理人；副手
hero|n. 英雄；男主角
heroine|n. 女英雄；女主角
actress|n. 女演员
chancellor|n. 大臣；总理
commander|n. 司令官；指挥官
director|n. 指导者；主任；导演；董事
proponent|n. 支持者；拥护者；辩护者
committee|n. 委员会
council|n. 理事会；委员会；议会
delegate|v. 委派；授权；n. 代表
specialist|n. 专家；专科医生
consultant|n. 顾问
veterinary|adj. 兽医的；n. 兽医
counsellor|n. 顾问；辅导员；律师
solicitor|n. 事务律师；初级律师
attorney|n. 律师；辩护律师；代理人
umpire|n. 裁判员；仲裁人；v. 当裁判；作仲裁
cashier|n. 出纳员，收银员；v. 革除（军职）
fireman|n. 消防队员
nurse|n. 护士；保姆；v. 护理；照料；喂奶
gardener|n. 园丁
barber|n. 理发师
haircut|n. 理发；发型
fisherman|n. 渔夫
butcher|n. 屠夫；肉贩；v. 屠宰；杀戮；adj. 更男性化的；更有男子气的；“butch”的比较级
groom|n. 新郎；马夫；v. 打扮；梳理毛发；培养
hostage|n. 人质
toil|v. 费力地做；苦干；跋涉；n. 苦工；劳累的工作
beggar|n. 乞丐
slave|n. 奴隶；v. 苦干
coward|n. 懦夫；胆小鬼；胆怯者；adj. 胆小的；怯懦的
act|v. 行动；表现；演戏；n. 行动；装模作样；（戏）幕；法令
behave|v. 表现；举止
deed|n. 行为；事迹
accustom|v. 使习惯；习惯于
react|v. 反应
respond|v. 回答；回应；n. 回答；回应
reflect|v. 反射；反映；反省；思考；仔细考虑
adopt|v. 收养；采用；采纳；正式通过
nourish|v. 滋养；培养；养育；怀有
mow|v. 刈；收割；扫杀；n. 麦秆堆；干草堆积处
support|v. 支持；支撑；n. 拥护；帮助
exhale|v. 呼出；散发
intake|n. 吸收之量；吸入；摄入
revive|v. 复活；复苏；再生；再用
survive|v. 幸存；生存；存活
glare|v. 发出刺眼的光；怒目而视；瞪视；n. 闪耀光；刺眼；瞪眼
glimpse|v. 瞥见；n. 一瞥
glance|v. 扫视；瞥一眼；浏览；n. 一瞥；扫视
peep|v. 窥看；微露出；唧唧叫；n. 窥视；隐现；唧唧声
gaze|v. 凝视；注视；n. 凝视；注视
peer|v. 凝视；盯着看；与...同等；n. 同等的人；同辈；贵族
stare|v. 凝视；盯着看；n. 凝视；盯
contemplate|v. 考虑；深思；凝视；思考…的可能性
vow|n. 誓言；誓约；v. 发誓；起誓
oath|n. 誓言；誓约；咒骂语
pledge|n. 誓言；保证；抵押物；v. 发誓；保证；典当
whistle|v. 吹口哨；鸣汽笛；n. 口哨声；汽笛声
reply|v. 答复；回答；n. 答复；回答
notify|v. 通知
assert|v. 断言；宣称；坚持；维护
explain|v. 解释；说明；阐明
quarrel|v. 争吵；吵架；吵嘴；n. 争吵；口角；拌嘴
dispute|n. 纠纷；争端；v. 对（某事）有异议；争执
argument|n. 争论；论点；辩论
mention|v. 提到；说到；n. 提及；说起
hurry|n. 匆忙；仓促；v. 抓紧；赶快；匆忙地做
hasten|v. 催促；赶紧；加速
urge|v. 催促；力劝；n. 强烈欲望；迫切要求
scold|v. 责骂；训斥
curse|v. 诅咒；咒骂；n. 诅咒；咒骂
swear|v. 发誓；咒骂
provoke|v. 激怒；激起
preach|v. 宣扬；鼓吹；布道
boast|v. 自夸；夸耀；自豪地拥有
tease|v. 取笑；戏弄；挑逗；梳理（毛、麻等）；n. 爱嘲弄他人的人；戏弄
mock|v. 嘲笑；嘲弄；（模仿）取笑；adj. 仿制的；模拟的；虚假的；n. 模拟考试；嘲弄；模仿
touch|v. 触摸；接触；触动；n. 触摸；触觉；触感
hug|v. 拥抱；紧抱；抱有；挨着；n. 拥抱；搂抱
clap|v. 鼓掌；拍手；n. 鼓掌；拍手
applaud|v. 鼓掌；称赞
kneel|v. 跪下
catch|v. 捕捉；接住；抓住；赶上；得病；理解；n. 捕捉；搭扣；钩；抛接球游戏
snatch|v. 攫取；夺取；抓住；n. 攫取；夺取；抓住
grab|v. 抓取；攫取
grasp|v. 抓紧；领会；n. 紧抓；领会
overtake|v. 赶上；超过
follow|v. 跟随；遵循
grip|v. 紧握；掌握；吸引；n. 紧握；掌握；控制；把手
mess|n. 脏乱；杂乱；v. 弄糟；弄乱
twist|v. 捻；搓；拧；扭转；曲折；n. 捻；搓；拧；扭转；曲折
scatter|v. 分散；（使）散开；散布
fold|v. 折叠；交叠；（企业等）倒闭；n. 折痕；褶
fasten|v. 拴紧；使牢固
loosen|v. 松开；放松
smash|v. 打碎；猛烈撞击；n. 打碎；破碎的哗啦声；撞车事故
scratch|v. 抓搔；刮；n. 抓痕；刮伤
wipe|v. 擦；抹；拭；消除；n. 擦拭；抹布
scrape|v. 刮；擦；刮出刺耳声；勉强通过；n. 刮；擦；擦痕；刮擦声
polish|v. 擦亮；磨光；润色；完善；n. 光泽；上光剂
split|v. 分开；分裂；n. 划分；分歧；裂缝
sway|v. 摇摆；摇动；影响；n. 摇摆；影响；支配
shake|v. 摇动；颤动；n. 摇动；颤动
vibrate|v. 振动；颤动
whirl|v. （使）回旋；（使）旋转；n. 一连串的事；混乱；尝试
rotate|v. 转动；轮作；轮流
shuffle|v. 拖曳；搅乱；洗牌；移来移去；n. 拖着脚走；洗牌；混在一起
collide|v. 碰撞；相撞；冲突
contact|n. 接触；联系；v. 接触；联系
connect|v. 连接；接通
combine|v. 组合；结合
integrate|v. （使）合并；（使）融入；积分
penetrate|v. 渗透；看穿；洞察
pierce|v. 刺穿；戳入
insert|v. 插入
tilt|v. （使）倾斜；（使）偏向；n. 倾斜；企图
tow|v. 牵引；拖；n. 牵引；拖
trail|v. 跟踪；尾随；拖；落后于；n. 小径；路径；踪迹
arrange|v. 安排，排列；改编（乐曲）
manipulate|v. 操纵；使用
steer|v. 驾驶；引导；掌舵；操纵；n. 犍牛
baptise|v. 给…施洗礼；洗礼时给（某人）命名
bet|n. 打赌；赌注；v. 打赌；敢说
stake|n. 股份；赌注；桩；v. 投下…的赌注；把…系于桩上
gamble|n. 赌博；冒险；打赌；v. 赌博；投机；冒险
promise|v. 承诺；答应；有希望；n. 许诺；希望；成功的征兆（或理由）
attract|v. 吸引
obsess|v. 使困扰；使着迷
mesmerise|v. 施以催眠术；迷住；迷惑
nightmare|n. 噩梦；不愉快的经历
amaze|v. 使惊奇；使吃惊
marvel|n. 奇异的事物；令人惊异的人（或事）；v. 惊异于；惊异
astonish|v. 使惊讶
involve|v. 牵涉；包括
annoy|v. 使烦恼；使气恼
upset|v. 推翻；打乱；使心烦；adj. 沮丧的；难过的；不安的
bewilder|v. 使迷惑；使...不知所措
irony|n. 讽刺；反语；讽刺之事；adj. 铁的；似铁的；含铁的
indignity|n. 侮辱；侮辱性言行
contempt|n. 蔑视；轻蔑
neglect|v. 疏忽；忽视；不予重视；n. 疏忽；大意
disregard|v. 漠视；不理会；不顾；n. 漠视；忽视
ignorance|n. 无知；愚昧
bias|n. 偏见；偏袒；偏爱；v. 使有偏见
deviate|v. 偏离；背离；违背
expel|v. 驱逐；开除；排出
flee|v. 逃跑；逃离
bully|v. 恐吓；威迫；欺负；n. 仗势欺人者；横行霸道者
panic|n. 恐慌；惊恐；v. 使…惊慌；感到恐慌
terrify|v. 使恐惧；使惊吓
revenge|n. 报复；报仇；v. 报复
kidnap|v. 绑架；劫持；诱拐；n. 绑架罪
hijack|v. 劫持（交通工具）；n. 劫持；劫机
smuggle|v. 走私；偷运
convict|v. 定罪；宣判有罪；n. 罪犯；囚犯
strangle|v. 勒死；扼杀；制止
massacre|v. 屠杀 ；n. 大屠杀
decimation|n. 大批杀害；大量死亡
intervene|v. 干涉；介入；打岔；干扰
impede|v. 阻碍；拖延进程
allure|n. 诱惑；吸引；v. 诱惑；吸引
bait|n. 鱼饵；诱惑物；v. 下诱饵
induce|v. 诱使；导致；劝说
tempt|v. 诱惑；引诱；怂恿；劝诱
designate|v. 任命；选派；指明；命名为；adj. 候任的
assign|v. 分配；指派
distribute|v. 分发；分配；散布；配给
despatch|v. 派遣；发送；n. 派遣；发送；信件
detach|v. 脱离；拆卸；分离
undo|v. 解开；撤销；毁掉
disguise|v. 伪装；掩饰；n. 伪装；伪装物
conceal|v. 隐藏；隐瞒
refuse|v. 拒绝；不接受；n. 废料；垃圾；废物
exclude|v. 拒绝；排斥；排除
reverse|v. 使倒转；使颠倒；（使）倒车；撤销；n. 反面；背面；adj. 相反的；反向的
assure|v. 保证
undertake|v. 承担；从事；保证
stipulate|v. 规定；订明；讲定；明确要求
convince|v. 说服；使确信
reassure|v. 使…安心；使消除疑虑；再保证
wish|n. 祝福；愿望；v. 祝愿；希望
aspire|v. 向往；渴望；追求；立志
desire|n. 欲望；渴望；v. 渴望；期望
yearn|v. 渴望；渴求
invoke|v. 祈求；援引；援用
itch|n. 痒；渴望；v. （使）痒；渴望
attempt|n. 企图；试图；v. 企图；试图
strive|v. 努力；奋斗；力求
effort|n. 努力；尽力
fulfil|v. 履行；实行；满足
sort|n. 种类；类别；v. 把…分类；拣选；理清；解决
loom|n. 织布机；若隐若现；v. 隐约可见；迫近
launch|v. 发射；发起；启动；掷；n. 发射；投掷；启动
commence|v. 开始发生；着手
exploit|v. 开拓；利用；开采；剥削；n. 功绩
explore|v. 探索；勘探
exert|v. 运用；施加
tackle|v. 处理；阻截；n. 用具；阻截
cope|v. 应付；处理
dispose|v. 安排；处置；处理；除去；有…倾向；有意于
conduct|v. 实施；表现；指挥；引导；传导（电、热）；n. 行为，举止；实施方式
omit|v. 省略；遗漏
delete|v. 删除；消去
cancel|v. 取消
clear|adj. 清楚的；明确的；清晰的；清澈的；晴朗的；v. 清空；清除；放晴；使明确；adv. 清楚地；彻底地
erase|v. 抹去；擦掉
rescue|n. 救援；营救；v. 救援；营救
resort|n. 诉诸；度假胜地；应急手段；v. 求助；诉诸
recover|v. 恢复；重新获得；复原
restore|v. 恢复
rectify|v. 纠正；矫正
redeem|v. 兑现；赎回；挽回；履行；补偿；偿还
offset|n. 抵消；补偿；偏移量；胶印术；v. 抵消；弥补；偏移
replenish|v. （再）装满；添加；补充
obtain|v. 获得；得到
gain|v. 获得；增加；n. 获得；增益
supply|n. 供应；供给；v. 供给
offer|n. 提议；提供；报价；v. 提供；愿意
render|v. 使变得；给予；（以某种方式）表达；翻译
enlarge|v. 扩大；放大
augment|v. 增加；增强；扩大
magnify|v. 放大；扩大；夸大
amplify|v. 放大，扩大；增强；详述
exaggerate|v. 夸张；夸大
prolong|v. 延长；拉长；拖长
uphold|v. 拥护；支持；维护
backup|n. 备份；后援
propel|v. 推进；推动
update|v. 更新；升级；n. 更新
raise|v. 提起；增加；养育；筹募；引起；n. 加薪
leak|v. 渗；漏；泄露；n. 漏洞；泄露
spill|v. 溢出；溅出；n. 溢出；溅出
seep|v. 渗出；渗漏；漏出
ooze|v. 渗出；流出；分泌出；n. 软泥；淤泥；泥浆
evacuate|v. 撤离；疏散；撤出
trench|n. 沟；海沟；渠；战壕；v. 掘沟；挖战壕；侵害
saturate|v. 使浸透；使湿透；使满；使饱和
excuse|n. 饶恕；借口；致歉；v. 宽恕；原谅；辩解
forgive|v. 原谅；宽恕
contain|v. 包含；容纳；克制；遏制
regard|v. 看待；认为；注视；有关；n. 尊敬；致意
flatter|v. 奉承；讨好；向…谄媚；adj. 更平坦的；更扁平的；“flat”的比较级；adv. 更平直地；更直截了当地；“flat”的比较级
worship|n. 崇拜；崇敬；礼拜；v. 崇拜；尊崇；做礼拜
cause|n. 原因；理由；理想；事业；v. 导致；引起
sake|n. 缘故；理由
purpose|n. 目的；意图
objective|n. 目标；目的；adj. 客观的
arouse|v. 引起（兴趣/愤怒等）
trigger|n. 触发；触发器；扳机；诱因；v. 触发；引起；发动
seek|v. 寻求；寻找
retrieve|v. 取回；重新获得；检索数据
testify|v. 作证；证明
verify|v. 核实；证实
specify|v. 详细说明；指定；阐述
enlighten|v. 启发；开导
impart|v. 传授；给予；告知
deserve|v. 值得；应得
drop|n. 滴；下落；v. 落下；掉下
sink|v. （使）沉没；（使）下陷；n. 洗涤槽；水槽
plummet|n. 铅垂；铅垂线；v. 垂直落下；暴跌
muffle|v. 使声音降低；压抑（声音）；蒙住；裹
overshadow|v. 蒙上阴影；使暗淡；使黯然失色
invite|v. 邀请；招致
welcome|n. 欢迎；v. 欢迎；int. 欢迎
greet|v. 问候；打招呼；迎接
salute|n. 敬礼；致敬；行礼；v. 敬礼；致敬；行礼
celebrate|v. 庆祝；歌颂
congratulate|v. 祝贺；恭喜
bless|v. 祝福；保佑
participate|v. 参与；参加
farewell|n. 再会；别了
assort|v. 把…分类； 协调；相称；交际； 交往
correspond|v. 符合；通信；相类似；相对应
accord|v. 符合；一致；给予；n. 协议；条约；协调
attribute|v. 由…引起；把…归因于；认为是…创作的；n. 属性；品质；特征；定语
recall|v. 召回；回忆起
recollect|v. 回想起；记起
remind|v. 提醒；使想起
retell|v. 重讲；复述
repeat|v. 重复；重做；n. 重复；重做
retrospect|n. 回想；v. 回想
impress|v. 使留下深刻印象；使铭记
surmount|v. 克服；越过；在...顶上
mortify|v. 使蒙屈辱；克制
pervade|v. 弥漫；遍及；蔓延
replace|v. 代替；取代；放回原处
substitute|v. 替代；n. 代用品；代替物
distinguish|v. 区分；使有别于；辨认；使出众
differentiate|v. 区分；区别；辨别
incline|v. 倾斜；倾向；n. 斜坡
lean|v. 倾斜；倚靠；adj. 精瘦的；精简的；不景气的
sideways|adv. 斜向一边地；adj. 斜着的
feel|v. 感到；触摸；认为；n. 感受；触觉
mood|n. 心情；情绪；气氛
emotion|n. 情绪；情感
temper|n. 暴躁脾气；情绪；心情；性情；v. 使…缓和；冲淡
manner|n. 方式；举止；礼节
attitude|n. 态度；看法；姿态
character|n. 人物角色；性格；特点；文字
personality|n. 人格；个性； 名人
trait|n. 特性；特点
virtue|n. 美德；优点
feature|n. 特征；报刊特写；v. 以…为特色；是…的重要组成；放映
stature|n. 身高；个子；声望
flesh|n. 肉体；果肉
mankind|n. 人类
human|adj. 人的；人类的；n. 人；人类
bone|n. 骨；骨头
backbone|n. 脊柱；中坚；骨干；骨气
skeleton|n. 骨架；骷髅；纲要；梗概；adj. 骨干的；骨骼的
skull|n. 颅骨；头骨
brain|n. 脑；脑力；智力
mind|n. 心；头脑；思路；智力；意向；情绪；v. 介意；专心于；注意；照顾
physical|adj. 身体的；外观的；物质的； 物理的；n. 体格检查
mental|adj. 精神的；心理的
cheek|n. 脸颊
forehead|n. 前额
brow|n. 额；眉毛；山顶
eyelash|n. 眼睫毛
lip|n. 嘴唇；边；缘；v. 用嘴唇接触；轻声说出
mouth|n. 嘴；口
tongue|n. 舌头；语言
throat|n. 嗓子；咽喉
gorge|n. 峡谷；山谷；v. 贪婪地吃；狼吞虎咽
chin|n. 下巴；颏
jaw|n. 颚；颌；下巴
neck|n. 颈；脖子
beard|n. 胡须；络腮胡子；v. 公然反抗
shoulder|n. 肩膀；v. 承担
limb|n. 肢体；树枝
elbow|n. 肘部；v. 用肘推挤；跻身；排挤
wrist|n. 手腕；腕关节
thumb|n. 大拇指；v. 以拇指拨弄；作搭车手势
palm|n. 手掌；手心；棕榈
finger|n. 手指
fist|n. 拳头
chest|n. 胸部；胸膛；箱子；柜子
abdomen|n. 腹部
rib|n. 肋骨
waist|n. 腰
organ|n. 器官；机构 ；风琴
liver|n. 肝脏
stomach|n. 胃；腹部；v. 忍受；吃得下
womb|n. 子宫；发源地
kidney|n. 肾；肾脏；腰子；脾气
lung|n. 肺
gland|n. 腺
chamber|n. 房间；室；腔；大会议室；议院
intestine|n. 肠
thigh|n. 大腿；股
joint|n. 关节；接合处；adj. 联合的；共同的；合办的
knee|n. 膝盖；膝部
lap|n. （人坐着时）大腿部；一圈；重叠的量；v. 超越一圈；（水）轻拍；舔
ankle|n. 踝；踝关节
heel|n. 足跟；脚后跟
toe|n. 脚趾；v. 用脚尖触
muscle|n. 肌肉；权力；影响力
pore|n. 毛孔；小孔；v. 细看；钻研；凝视
pulse|n. 脉冲；脉搏；脉动；v. 脉动；搏动；（心脏）跳动
artery|n. 动脉；干线；要道
nerve|n. 神经；勇气；胆量
hormone|n. 荷尔蒙；激素
immune|adj. 免疫的；有免疫力的；不受影响的
stimulus|n. 刺激物；促进因素；激励因素
biorhythm|n. 生物节律
lifestyle|n. 生活方式
habit|n. 习惯
sense|n. 知觉；感知；理解力；意义；v. 意识到；感觉到；觉察出
sight|n. 看见；景象；视力；v. 看到；观测
eyesight|n. 视力；视觉
view|n. 视野；风景；见解；v. 审视；观看
visual|adj. 视力的；视觉的
visible|adj. 看得见的
vague|adj. 含糊的；不明确的
blind|adj. 瞎的；失明的；v. 使失明；n. 百叶窗
dumb|adj. 哑的；沉默的；愚笨的
aural|adj. 听觉的；听的
dental|adj. 牙齿的；牙科的
awake|v. 醒来；唤起；adj. 醒着的
yawn|v. 打呵欠；n. 呵欠
nap|n. 小睡；打盹；v. 小睡；打盹
doze|v. 打瞌睡；n. 瞌睡
quiet|adj. 安静的
asleep|adj. 睡着的
cripple|n. 跛子；（身体部分和全部肢体）有缺陷的人；v. 使成瘸子；严重损坏（削弱）
lame|adj. 瘸的；跛的；站不住脚的；无说服力的；v. 变跛；瘸行
dwarf|n. 侏儒；矮子；矮星；v. （使）显得矮小；使相形见绌
pregnancy|n. 妊娠；怀孕；孕期
born|adj. 出生的；天生的；v. 生（孩子）；“bear”的过去分词
condom|n. 避孕套；阴茎套
clone|v. 克隆；无性繁殖；n. 克隆；无性繁殖
symptom|n. 征兆；症状
disease|n. 病；疾病
illness|n. 病；疾病
moan|v. 呻吟；呼啸；抱怨；n. 呻吟声；萧萧声；抱怨
infection|n. 感染；传染
detriment|n. 损伤；损害物
broken|adj. 破损的；弄坏的；v. 打破；打断；休息； “break”的过去分词
disable|v. 使残废；使无能力
invalid|adj. 无效的；作废的；n. 病弱者；伤残者
patient|adj. 有耐心的；n. 病人
dysfunction|n. 机能障碍
diabetes|n. 糖尿病；多尿症
obesity|n. 肥胖；肥胖症
overweight|adj. 超重的；v. 使超重；过于重视；n. 超重
hypertension|n. 高血压；过度紧张
paralyse|v. 使麻痹；使瘫痪；使无效；使停止活动
dizzy|adj. 头晕目眩的；头昏眼花的
insane|adj. 疯狂的；精神失常的；精神错乱的
insomnia|n. 失眠（症）
allergy|n. 过敏症；反感；厌恶
heart attack|phrase. 心脏病发作
cancer|n. 癌；癌症
arthritis|n. 关节炎
pimple|n. 皮肤上的红色小疱
stroke|n. 一击；打击；中风； 轻抚；划水动作；钟鸣；v. 轻抚
plague|n. 瘟疫；疫病；v. 困扰；折磨
flu|n. 流感；流行性感冒
fever|n. 发烧
headache|n. 头痛；麻烦；令人头痛的人（或事物）
swell|v. 膨胀；肿胀
choke|n. 窒息；阻塞；v. 窒息；阻塞
injure|v. 损害；伤害
injury|n. 损伤；伤害
hurt|v. 受伤；感到疼痛；n. 伤痛
bleed|v. 流血；放血
bruise|v. 挫伤；擦伤；（使）出现伤痕；n. 伤痕；擦伤；瘀伤
scar|n. 伤疤；精神创伤；v. 留下疤痕
wound|n. 伤口；创伤；v. 使受伤；伤害；v. 蜿蜒；缠绕；“wind”的过去式和过去分词
trauma|n. 身体上的伤；精神上的创伤；外伤
lump|n. 块；肿块；隆起；v. 混在一起；结块；勉强接受
pain|n. 痛苦；苦恼
death|n. 死亡
mortal|n. 凡人；adj. 致命的；终有一死的
demise|n. 死亡；逝世；消亡；（不动产的）转让；让位
doom|n. 厄运；毁灭；死亡；v. 注定；判决
fatal|adj. 致命的；灾难性的
lethal|adj. 致命的；可致死的
corpus|n. 文集；文献；语料库
overwork|n. 过度工作；过度劳累；滥用；v. 工作过度；劳累过度；对…使用过度
tire|n. 轮胎；车胎；v. 使疲倦；使厌烦
exhaust|v. 耗尽；用完；使筋疲力尽；n. 排气管；废气
fatigue|n. 疲乏；劳累
faint|adj. 微弱的；缺少热情的；虚弱的；v. 昏厥
feeble|adj. 虚弱的；衰弱的；无力的
weary|adj. 疲倦的；厌烦的；v. （使）厌倦；厌烦
weaken|v. 削弱；变弱
uncomfortable|adj. 使人不舒服的；感到难受的；不自在的
unconscious|adj. 无知觉的；无意识的
chronic|adj. 长期的；慢性的
acute|adj. 敏锐的；灵敏的；急性的；严重的；成锐角的
sore|adj. 疼痛的；痛心的；惹人恼怒的；n. 痛处；伤处
sorrow|n. 悲痛；伤心
suffering|n. 痛苦；苦难；折磨；v. 遭受；忍受；“suffer”的现在分词；adj. 受苦的；患病的
lament|n. 悲叹；悼词；挽歌；v. 哀悼；惋惜；悲叹
hospital|n. 医院
therapy|n. 治疗；疗法
health care|phrase. 卫生保健；健康护理
sanitary|adj. 清洁的；卫生的；n. 公共厕所
medical|adj. 医疗的；医术的
curative|adj. 医疗的；治疗的；n. 药品
hygiene|n. 卫生；卫生学
fitness|n. 适宜；健康；健壮
clinic|n. 诊所；诊科
physician|n. 医生；内科医生
surgeon|n. 外科医生
operation|n. 操作；运行；手术
cure|n. 治疗；疗法；v. 治愈；治疗
heal|v. 复原；治愈
treatment|n. 治疗；处理；待遇
check|v. 检查；核实；克制；n. 检查；支票；方格图案
prescription|n. 处方；药方
transplant|v. 移栽；移植；n. 移植
X-ray|n. X射线
injection|n. 注射；注射剂；注入
precaution|n. 预防；预防措施
vaccinate|v. 接种疫苗；预防接种
quarantine|n. 隔离检疫期；v. 检疫；隔离
segregate|v. （使）分开；分离；隔离
isolate|v. 使孤立；使隔离；分离出；n. 隔离种群
pharmacy|n. 药房；药剂学
medicine|n. 药；医学
remedy|n. 疗法；纠正办法；v. 纠正；治疗
drug|n. 药物；毒品；v. 使服麻醉药；使服毒品
pill|n. 药丸；药片
antibiotic|adj. 抗生的；抗菌的；n. 抗菌素；抗生素
acupuncture|n. 针刺疗法；v. 对…施行针刺疗法
penicillin|n. 青霉素
morphine|n. 吗啡
dose|n. 剂量；一剂；v. 给...服药
recovery|n. 恢复；复苏
refresh|v. 使恢复精力；使复原；使变新
relief|n. 减缓；解脱；宽慰；救济
relieve|v. 减轻；缓解
alleviate|v. 减轻；缓解；缓和
resume|v. （中断后）继续；重新开始；n. 简历
ease|v. 缓解；减轻；n. 安逸；轻松
relax|v. 放松；松懈
normal|adj. 正常的；一般的
common|adj. 常见的；普通的；共有的
usual|adj. 通常的；寻常的；惯常的
optimistic|adj. 乐观的
pessimistic|adj. 悲观的；厌世的
positive|adj. 积极的；正面的
negative|adj. 否定的；消极的；负面的；n. 否定的表达；负数；底片
passive|adj. 消极的；被动的；被动语态的
enthusiastic|adj. 充满热情的；热心的
indifferent|adj. 不感兴趣的，不关心的；（水平）一般的
apathetic|adj. 缺乏兴趣的；漠不关心的
negligible|adj. 可以忽略的；微不足道的
happiness|n. 幸福；快乐
delight|n. 高兴；快乐；v. 使高兴；使愉快
merry|adj. 欢乐的
fun|n. 乐趣；快乐
joke|n. 笑话；玩笑；v. 开玩笑
laughter|n. 笑声；笑
joy|n. 喜悦；快乐
please|int. 请；v. 使欢喜；取悦
rejoice|v. 欢喜；高兴；喜悦
thrill|n. 兴奋；震颤感；引起激动的事物；v. 激动；震颤；兴奋
cheer|v. 欢呼；鼓舞；使鼓起精神；n. 欢呼声；激励
pleasure|n. 快乐；高兴；愉快；v. 使高兴
agreeable|adj. 愉悦的；宜人的；欣然同意的
exhilarate|v. 使高兴；使振奋
satisfactory|adj. 令人满意的
desirable|adj. 值得要的；令人渴望的；称心如意的
exciting|adj. 令人激动的；使人兴奋的；v. 使兴奋；使激动； “excite”的现在分词
keen|adj. 热心的；敏锐的；渴望的
zeal|n. 热情；热忱
lively|adj. 活泼的；充满生机的；欢快的；栩栩如生的；adv. 轻快地
lovely|adj. 可爱的；美丽的
fond|adj. 喜爱的；喜欢的
favour|n. 喜爱；赞同；v. 赞成；有利于；偏爱
startle|v. （使）惊动；（使）惊愕；（使）吃惊
amazing|adj. 令人惊异的；令人惊叹的；v. 使惊奇；使吃惊；“amaze”的现在分词
astound|v. 使震惊；使大惊
hectic|adj. 紧张忙碌的；忙乱的
liberal|adj. 开明的；自由主义的；慷慨的；n. 自由主义者；自由党党员
generous|adj. 慷慨的；大方的
gentle|adj. 温和的；文雅的；温柔的
humble|adj. 谦逊的；虚心的；卑微的；v. 感到谦卑；感到自惭
modest|adj. 谦虚的；不多的；适度的
humorous|adj. 幽默的；风趣的
polite|adj. 有礼貌的；客气的；文雅的
frank|adj. 坦率的；真诚的
mysterious|adj. 神秘的
curious|adj. 好奇的
daring|adj. 大胆的；勇敢的；v. 敢于；胆敢；“dare”的现在分词
manly|adj. 有男子气概的；阳刚的
direct|adj. 直接的；v. 指导；指示
earnest|adj. 认真的；有决心的；真诚的
honesty|n. 诚实；正直；老实
proud|adj. 自豪的；骄傲的
seriously|adv. 严肃地；认真地；严重地
friendly|adj. 友好的
hospitable|adj. 好客的；热情友好的；殷勤的；（气候、环境等）适宜的
romantic|adj. 浪漫的
freedom|n. 自由
careful|adj. 小心的；仔细的
concern|v. 涉及；担忧；n. 担忧；挂念；关注；关心
confidence|n. 信心；信任；秘密；私事
considerate|adj. 考虑周到的；体贴的
thoughtful|adj. 深思的；体贴的
sympathetic|adj. 同情的
ready|adj. 准备好的；v. 使...准备好
apologise|v. 道歉
apology|n. 道歉；谢罪
mercy|n. 仁慈；怜悯
admire|v. 钦佩；赞赏
remarkable|adj. 值得注意的；显著的；非凡的；不寻常的
grateful|adj. 感激的；表示感谢的
gratitude|n. 感激之情；感谢
eager|adj. 热切的；渴望的
sound|n. 声音；声响；v. 响；听起来；adj. 健全的；完好的；合理的；可靠的；酣睡的
picturesque|adj. 如画的；（语言）生动的
promising|adj. 有希望的；有前途的；v. 承诺；答应； “promise”的现在分词
prominent|adj. 突出的；显著的；杰出的
awesome|adj. 令人敬畏的；令人畏惧的；棒极了
arduous|adj. 艰巨的；费力的
tough|adj. 强硬的；艰苦的；严厉的
robust|adj. 强健的；强壮的；结实的
sturdy|adj. 强健的；坚固的；坚决的
steadfast|adj. 坚定的；不动摇的
tender|adj. 嫩的；温柔的；纤弱的；疼痛的；n. 看管者；投标；补给船；煤水车；v. 正式提出；投标
temperate|adj. 有节制的；克制的；温和的
delicate|adj. 微妙的；易碎的；脆弱的；精致的
mundane|adj. 世俗的；平凡的
naive|adj. 幼稚的；天真的；不成熟的
childish|adj. 孩子气的；幼稚的
sincere|adj. 真诚的；诚挚的
liable|adj. 有…倾向的；有（法律）责任的；易受…影响的
trustworthy|adj. 可信赖的；可靠的
enterprising|adj. 有事业心的；有进取心的；有魄力的
sane|adj. 心智健全的；头脑清醒的；明智的
strenuous|adj. 费力的；繁重的；艰苦的；发奋的
rigorous|adj. 严密的；缜密的；严格的
strict|adj. 严格的；严厉的
severe|adj. 严重的；非常困难的；严厉的
mutual|adj. 相互的；共同的
resemble|v. 相似；类似
similar|adj. 类似的；相像的
familiar|adj. 熟悉的
naked|adj. 裸体的；裸露的
bare|adj. 赤裸的；空的；光秃秃的；仅有的；v. 使露出
private|adj. 私人的
intuition|n. 直觉；直觉的知识
spontaneous|adj. 自发的；自然产生的
implicit|adj. 含蓄的；暗示的；无疑的；绝对的
illusion|n. 错觉；幻觉
imaginary|adj. 想象中的；虚构的
fancy|n. 幻想；想象力；爱好；怪想；adj. 花哨的；昂贵的；新奇的；v. 想象；设想；想要；喜爱
fate|n. 命运；宿命
fortune|n. 命运；财产；运气
agony|n. 极度痛苦
grief|n. 悲痛；忧伤
grieve|v. 伤心；悲痛；使悲痛；使伤心
miserable|adj. 悲惨的；可怜的
distress|n. 忧虑；悲伤；危难；v. 使烦乱
sadness|n. 悲伤；悲哀
gloomy|adj. 黑暗的；幽暗的；忧郁的；沮丧的
disappoint|v. 使失望；使破灭；使落空
discourage|v. 劝阻；阻止；使气馁
wretched|adj. 悲惨的；不幸的；难过的；恶劣的
frustrating|adj. 令人沮丧的；令人泄气的；让人懊恼的；v. 挫败；使沮丧； “frustrate”的现在分词
mourn|v. 悼念；哀痛
anger|n. 愤怒；怒气
furious|adj. 狂怒的；暴怒的；激烈的
frown|v. 皱眉；蹙额；n. 皱眉；蹙额
rage|n. 盛怒；风靡一时；v. 发怒；怒斥；（战斗、争论）激烈进行；（暴风雨）肆虐
irritate|v. 激怒；使急躁；使疼痛
hate|v. 讨厌；憎恨；n. 憎恨；厌恶
hatred|n. 憎恨；仇恨
nuisance|n. 讨厌的人；讨厌的事
disgust|n. 厌恶；反感；v. 使厌恶；使作呕
vex|v. 使恼火；使烦恼
harass|v. 骚扰；烦扰；屡次侵扰
bore|n. 钻孔；令人讨厌的人或事；v. 开凿；钻孔；使厌烦；v. 忍受； “bear”的过去式
bother|v. 打扰；麻烦；烦扰
troublesome|adj. 令人烦恼的；讨厌的；困难的
awful|adj. 可怕的；糟糕的；讨厌的；adv. 非常；极其
unpleasant|adj. 令人不快的；不舒服的；不友好的
adverse|adj. 不利的；有害的；相反的；敌对的
hostile|adj. 敌意的；敌对的
indignant|adj. 愤慨的；义愤的
radical|adj. 根本的；彻底的；激进的；n. 激进分子
mad|adj. 发疯的；疯狂的；生气的
crazy|adj. 疯狂的；狂热的
wicked|adj. 邪恶的；缺德的；淘气的
vicious|adj. 邪恶的；恶毒的；堕落的
vulgar|adj. 庸俗的；粗俗的；粗野的；下流的
ego|n. 自我；自负；自尊心
selfish|adj. 自私的
nasty|adj. 丑陋的；令人不愉快的；下流的；肮脏的
rash|n. 疹子；爆发；同时大量出现的事件；adj. 鲁莽的；轻率的
volatile|adj. 不稳定的；反复无常的；易挥发的；n. 挥发物
weird|adj. 离奇的；古怪的；怪异的
excessive|adj. 过度的；过分的
anxiety|n. 忧虑；焦虑；渴望
restless|adj. 坐立不安的；不安宁的；好动的
uneasy|adj. 不安的；不自在的；忧虑的
fear|v. 害怕；惧怕；n. 害怕；惧怕
timid|adj. 胆小的；羞怯的
fuss|n. 不必要的紧张；忙乱；大惊小怪；v. 瞎忙活；大惊小怪；过分关爱
insult|v. 侮辱；辱骂；n. 侮辱；辱骂
unkind|adj. 不和善的；不仁慈的；刻薄的；无情的
envy|v. 羡慕；妒忌
jealous|adj. 妒忌的；嫉妒的
doubt|v. 怀疑；拿不准；n. 疑问；疑惑
suspicion|n. 怀疑；猜疑
sceptical|adj. 怀疑的
unsatisfactory|adj. 不够好的；不能令人满意的
unstable|adj. 不稳定的
unsuitable|adj. 不适宜的；不合适的
unwilling|adj. 不愿意的；不情愿的
reluctant|adj. 不情愿的；勉强的
hesitate|v. 犹豫；踌躇
confuse|v. 迷惑；混淆
guilty|adj. 有罪的；内疚的
embarrass|v. 使窘迫；使尴尬
regret|n. 遗憾；痛惜；v. 懊悔；惋惜
repent|v. 后悔；忏悔；悔过
ashamed|adj. 羞愧的；惭愧的
sigh|v. 叹息；叹气；n. 叹息；叹气
weep|n. 哭泣；落泪；v. 流泪；流出
tolerance|n. 宽容；忍耐力
ignorant|adj. 无知的；缺乏知识的
endure|v. 忍受；忍耐
sly|adj. 诡诈的；诡秘的；心照不宣的
cunning|adj. 狡猾的；奸诈的；巧妙的；n. 奸诈；狡猾
arbitrary|adj. 任意的；专横的；武断的
ridiculous|adj. 荒谬的；可笑的
stupid|adj. 愚蠢的；笨的
awkward|adj. 尴尬的；笨拙的；别扭的
clumsy|adj. 笨拙的；不灵巧的
careless|adj. 粗心的
oblivious|adj. 没注意到的；未觉察的；忘却的
naughty|adj. 顽皮的；淘气的
greedy|adj. 贪婪的
obtrusive|adj. 显眼的；刺眼的
slothful|adj. 怠惰的；懒散的
sluggish|adj. 缓慢的；迟缓的；懒洋洋的
impulse|n. 冲动；脉冲；冲动力
rigid|adj. 坚硬的；严格的；刻板的；僵直的
stubborn|adj. 固执的；顽固的；倔强的
stereotype|n. 刻板印象；陈规老套；v. 对…存有成见；把…模式化
daily|adv. 每天；每日；adj. 每天的；每日的；n. 日报
monthly|adj. 每月的；每月一次的；adv. 每月一次；每个月；n. 月刊
quarterly|adj. 季度的；adv. 每季一次；n. 季刊
annual|adj. 每年的；一年一次的；n. 年刊；年鉴
yearly|adj. 每年的；adv. 每年地
anniversary|n. 周年纪念日
era|n. 时代；纪元
present|n. 目前；礼物；adj. 在场的；目前的；v. 呈现；提出
contemporary|adj. 现代的；当代的；同时代的；n. 同代人；同辈人；同龄人
medieval|adj. 中世纪的；中古的
century|n. 世纪；百年
millennium|n. 一千年；千禧年；（未来的）太平盛世
million|num. 一百万；n. 百万；百万个
billion|num. 十亿
dozen|n. 很多； 一打；十二个
dawn|n. 黎明；破晓；v. 破晓；开始明朗
midday|n. 中午；正午
midnight|n. 午夜；子夜
overnight|adv. 在夜里；突然；adj. 整晚的；突然的
night|n. 夜晚；晚上
modern|adj. 现代的；时髦的
recent|adj. 近来的；新近的
up-to-date|adj. ¸新的；¸近的；新式的
first|n. 第一；adj. 第一的；adv. 第一；首先
secondly|adv. 第二；其次
finally|adv. ¸后；终于
finish|v. 完成；结束
immediately|adv. 立即；马上；conj. 即刻
instant|n. 瞬间；立即；adj. 立即的；即时的
moment|n. 瞬间；片刻
minute|n. 分钟；一会儿；adj. 微小的
prior|adj. 优先的；在前的
former|adj. 以前的；前者的；n. 模子
preceding|adj. 在先的；在前的
precedent|n. 先例；前例
foremost|adj. ¸重要的；¸好的；adv. 首要地
opening|n. 开始；开口；空缺职位；adj. 开始的；v. 打开；“open”的现在分词
initially|adv. ¸初；开始；起初
intermediate|adj. 中间的；居中的
midst|n. 中间；中部
meantime|n. 期间；与此同时
meanwhile|adv. 与此同时；在此期间
simultaneous|adj. 同时的；同步的
ongoing|adj. 正在进行的
everlasting|adj. 永久的；永恒的；经久不变的
permanent|adj. 永久的；持久的
punctual|adj. 准时的
duration|n. 持续时间；期间
consecutive|adj. 连续的；连贯的
periodically|adv. 周期性地；定期地
imminent|adj. 即将发生的；临近的
incidentally|adv. 附带地；偶然地；顺便地