excuse|n. 饶恕；借口；致歉；v. 宽恕；原谅；辩解
me|pron. 我（宾语）
yes|adv. 是；n. 是
is|v. 是
this|adj. 这；pron. 这个；adv. 这个；这样；这么
your|pron. 你的；你们的
handbag|n. 手提包
pardon|v. 原谅；宽恕；请再说一遍；n. 原谅；宽恕
it|pron. 它
thank you|phrase. 谢谢你
very much|phrase. 很；非常
pen|n. 钢笔；笔；围栏
pencil|n. 铅笔
book|n. 书；账簿；v. 预订
watch|v. 观看；观察；小心；n. 手表；监视；注意
coat|n. 大衣；外衣；v. 给…穿上外衣；覆盖
dress|n. 连衣裙；衣服；v. （给…）穿衣服
skirt|n. 裙子；下摆；边缘；v. 位于…的边缘；绕着…走；避开
shirt|n. 衬衫
car|n. 小汽车
house|n. 房子；房屋
umbrella|n. 伞；雨伞
please|int. 请；v. 使欢喜；取悦
here|adv. 这里
my|adj. 我的
ticket|n. 票；车票
number|n. 数字；号码
five|num. 五
sorry|adj. 对不起的；遗憾的；抱歉的；int. 对不起；抱歉
sir|n.先生； 阁下
cloakroom|n. 衣帽间；厕所
suit|n. 套装；西装；诉讼；v. 适合；相配
school|n. 学校；v. 教育
teacher|n. 教师
son|n. 儿子
daughter|n. 女儿
Mr.|n. 先生
good|adj. 好的；优秀的
morning|n. 早晨；上午
Miss|n. 小姐
new|adj. 新的
student|n. 学生
French|adj. 法国的；法国人的；法语的；n. 法语；法国人
German|adj. 德国的；德国人的；德语的；n. 德国人；德语
nice|adj. 令人愉快的；美好的
meet|v. 遇见；见面；满足
Japanese|adj. 日本的；日本人的；日语的；n. 日语；日本人
Korean|n. 朝鲜人；韩国人；朝鲜话；韩国语；adj. 朝鲜（或韩国）的；朝鲜（或韩国）人的；朝鲜（或韩）语的
Chinese|n. 中国人；汉语；adj. 中国的
too|adv. 也；过于
make|v. 做；制作；使得
Swedish|adj. 瑞典的；瑞典人的；瑞典语的；n. 瑞典语；瑞典人
English|n. 英语；英文；adj. 英国的；英国人的；英语的
American|n. 美国人；美洲人；adj. 美国的；美洲的
Italian|n. 意大利语；意大利人；adj. 意大利的；意大利人的；意大利语的
Volvo|n. 沃尔沃（富豪）汽车
Peugeot|n. 法国标致（法国汽车公司）
Mercedes|n. 梅塞德斯（奔驰）；默西迪丝（女子名）
Toyota|n. 丰田汽车
Daewoo|n. 大宇（韩国大宇汽车公司）
Mini|n. 迷你汽车
Ford|n. 福特汽车
Fiat|n. 菲亚特汽车
I|pron. 我（主语）；n. 碘（元素iodine的符号）
am|v. 是；动词be的第一人称单数现在式；abbr. 上午；“ante meridiem”的缩写
are|v. 是
name|n. 姓名；名称；v. 命名；提名；说出…的名字
what|pron. 什么
nationality|n. 国籍；民族
job|n. 工作
keyboard|n. 键盘
operator|n. 操作员；接线员
engineer|n. 工程师；机械师；v. 设计（工程）；策划
policeman|n. （男）警察
policewoman|n. 女警察
taxi driver|n. 出租车司机
air hostess|phrase. 空中小姐
postman|n. 邮递员；邮差
nurse|n. 护士；保姆；v. 护理；照料；喂奶
mechanic|n. 技工；机械师；机修工
hairdresser|n. 理发师；美发师
housewife|n. 家庭主妇
milkman|n. 送牛奶的人
hello|int. 喂；哈喽；n. “喂”的招呼声或问候声
hi|int. 嗨；你好
how|adv. 如何；怎样；多么
today|n. 今天；当今；adv. 在今天；当今
well|adv. 好；对；满意地；adj. 健康的；n. 泉；井；油井；int. （用于表示惊讶，疑虑，接受等）好
fine|adj. 很好的；晴朗的；健康的；adv. 很好；n. 罚款；v. 罚款
thanks|int. 谢谢；n. 感谢；“thank”的复数；v. 谢谢；“thank”的第三人称单数
goodbye|int. 再见；n. 说再见
see|v. 看；领悟
fat|adj. 肥的；n. 脂肪
woman|n. 女人；妇女
thin|adj. 瘦的；薄的
tall|adj. 高的
short|adj. 短的；矮的
dirty|adj. 肮脏的；v. 使变脏
clean|v. 打扫；使干净；adj. 洁净的；干净的
hot|adj. 热的
cold|n. 寒冷；感冒；adj. 寒冷的；冰冷的
old|adj. 老的；旧的；年老的
young|adj. 年轻的；年幼的
busy|adj. 忙碌的；忙于
lazy|adj. 懒惰的；懒散的
whose|pron. 谁的
blue|adj. 蓝色的；忧郁的；n. 蓝色
perhaps|adv. 或许；可能
white|adj. 白色的；n. 白色
catch|v. 捕捉；接住；抓住；赶上；得病；理解；n. 捕捉；搭扣；钩；抛接球游戏
father|n. 父亲；爸爸
mother|n. 母亲
blouse|n. 宽松的女短衫；女衬衫
sister|n. 姐妹
tie|n. 领带；关系；约束；平局；淘汰赛；v. 绑；系；拴；约束；与...成平局
brother|n. 兄弟
his|pron. 他的（he的所有格）
her|pron. 她的（she的所有格）
colour|n. 颜色；v. 着色
green|adj. 绿色的；未熟的；无经验的；n. 绿色；绿色物品
come|v. 来；到来
upstairs|adv. 在楼上；往楼上；adj. 楼上的；上层的；n. 楼上
smart|adj. 聪明的；敏捷的；时髦的；衣冠楚楚的；v. 剧痛；刺痛；感到难过
hat|n. 帽子
same|adj. 相同的
lovely|adj. 可爱的；美丽的
case|n. 事例；情况；案件；外壳；容器（箱，盒）
carpet|n. 地毯
dog|n. 狗；v. 尾随
customs|n. 关税；海关；n. 习俗；习惯；“custom”的复数
officer|n. 军官；官员
girl|n. 女孩
Danish|adj. 丹麦的；丹麦人的；丹麦语的；n. 丹麦语
friend|n. 朋友
Norwegian|adj. 挪威（人，语）的；n. 挪威人；挪威语
passport|n. 护照；通行证
brown|adj. 褐色的；棕色的；n. 褐色；棕色
tourist|n. 旅游者；观光者
Russian|n. 俄罗斯人；俄语；adj. 俄国的；俄国人的；俄语的
Dutch|adj. 荷兰的；荷兰人的；荷兰语的；n. 荷兰人；荷兰语
these|pron. 这些；“this”的复数；adj. 这些的
red|adj. 红的；n. 红色
grey|adj. 灰色的；暗淡的；n. 灰色；暗淡
yellow|adj. 黄色的；n. 黄色
black|adj. 黑色的；n. 黑色
orange|adj. 橙色的；n. 橙色；橙子
employee|n. 雇员；受雇者
hard-working|adj. 勤勉的；努力工作的
sales rep|phrase. 推销员
man|n. 男人；人；v. 操作；工作
office|n. 办公室
assistant|n. 助理；助手；adj. 助理的；辅助的
matter|n. 事情；物质；问题；麻烦；v. 要紧
children|n. 儿童；小孩；“child”的复数
tired|adj. 疲倦的；厌烦的；v. 使疲倦；使厌烦；“tire”的过去式和过去分词
boy|n. 男孩
thirsty|adj. 口渴的；渴望的
Mum|n. 妈妈
sit down|phrase. 坐下
right|adj. 右边的；正确的；n. 权利；右边；adv. 正确地；直接地；向右；v. 扶直；纠正
ice cream|n. 冰淇淋
big|adj. 大的
small|adj. 小的
open|v. 打开；开放；adj. 开放的；营业的；n. 公开；户外
shut|v. 关；闭；adj. 关闭的；停止营业的
light|n. 光；灯；光线；adj. 轻的；浅的；明亮的；少量的；v. 点燃；照亮
heavy|adj. 重的；沉重的
long|adj. 长的；长时间的；adv. 长久地；始终；n. 长时间；长期；v. 渴望；盼望
shoe|n. 鞋
grandfather|n. 祖父；爷爷
grandmother|n. 祖母；外祖母
give|v. 给予；发出
one|num. 一
which|pron. 哪个；adj. 哪个的
empty|adj. 空的；v. 倒空；变空
full|adj. 满的；充满的；adv. 完全地；n. 完全；完整
large|adj. 大的
little|adj. 少的；小的
sharp|adj. 锋利的；灵敏的；尖刻的；骤变的
blunt|adj. 不锋利的；耿直的；v. 使变钝
box|n. 箱子；盒子；一拳；v. 拳击；装箱
glass|n. 玻璃；玻璃杯
cup|n. 杯子；茶杯
bottle|n. 瓶子；v. 用瓶装
tin|n. 锡；罐头
knife|n. 刀
fork|n. 叉子；分岔；分支；v. 分岔；用叉子叉
spoon|n. 勺子；汤匙
on|prep. 在……上
shelf|n. 架子；搁板
desk|n. 桌子；书桌
table|n. 桌子；台子；表格；v. 把…列入议事日程；搁置
plate|n. 盘子；碟子
cupboard|n. 碗橱；衣橱；橱柜
cigarette|n. 香烟；纸烟
television|n. 电视机；电视节目；电视行业
floor|n. 地板；地面；楼层
dressing table|phrase. 梳妆台
magazine|n. 杂志
bed|n. 床；底；（花）坛
newspaper|n. 报纸
stereo|n. 立体声；立体声音响；adj. 立体声的
Mrs.|abbr. 太太；夫人；“Mistress”的缩写
kitchen|n. 厨房
refrigerator|n. 冰箱
electric|adj. 电的；用电的
left|v. 离开；“leave”的过去式和过去分词；n. 左；左边；adj. 左边的；adv. 向左；在左边
cooker|n. 炊具；炉子；灶
middle|n. 中间；adj. 中间的
of|prep. 关于；属于
room|n. 房间；空间
where|adv. 在哪里
in|prep. 在…里面；在
living room|phrase. 客厅；起居室
near|adj. 近的；prep. 靠近；在…附近；adv. 近地
window|n. 窗口；窗户
armchair|n. 扶手椅；单座沙发
door|n. 门
picture|n. 图画；照片；v. 想象；描述
wall|n. 墙壁
trousers|n. 裤子；长裤
bedroom|n. 卧室
untidy|adj. 不整洁的；凌乱的
must|auxv. 必须；一定要；n. 必须做的事；必不可少的事物
air|n. 空气；空中；气氛；神态；v. （使）通风；播出；晾干
put|v. 放；放置
clothes|n. 衣服；服装
wardrobe|n. 衣柜；衣橱
dust|n. 粉尘；尘埃；v. 擦去…的灰尘
sweep|v. 扫；打扫；掠过；扫荡；n. 扫；打扫；掠过；席卷
read|v. 读；阅读
sharpen|v. 使尖锐；使急剧；使提高
put on|phrase. 穿戴；上演；增加（体重）
take off|phrase. 拿掉；离开；起飞；脱下；突然成功
turn on|phrase. 开启；接通；发动；突击
turn off|phrase. 关掉
garden|n. 花园；v. 从事园艺
under|prep. 在…下面；低于
tree|n. 树；树木
climb|v. 攀爬；爬升
who|pron. 谁
run|v. 跑步；经营；n. 跑；运转
grass|n. 草；草地；大麻；告密者；v. 使吃草；放牧；告发
after|adv. 以后；后来；prep. 在…之后
across|adv. 横过；穿过；越过；在对面；prep. 穿过；横过；在…对面
cat|n. 猫
type|n. 类型；种类；典型；字体；v. 打字；定型；成为…的典型
letter|n. 信；字母
basket|n. 篮子；篮；筐
eat|v. 吃
bone|n. 骨；骨头
tooth|n. 牙齿
cook|n. 厨师；v. 烹饪
milk|n. 奶；v. 挤奶
meal|n. 一餐；一顿饭
drink|v. 喝；喝酒；n. 饮料；酒
tap|n. 水龙头；轻拍；轻敲；轻击；v. 轻拍；轻敲；利用；提取
day|n. 日；天；时代
cloud|n. 云朵；云层；v. 布满云；使不清楚
sky|n. 天空
sun|n. 太阳；阳光
shine|v. 照耀；发光；闪耀
with|prep. 用；和；有；对
family|n. 家庭；家族；（动、植物的）科；（语言的）族、系；adj. 家庭的；家族的
walk|v. 行走；n. 步行
over|adv. 结束；越过；大于；prep. 越过；遍于…之上
bridge|n. 桥；桥梁
boat|n. 小船；v. 划船；用船运输；用船装运
river|n. 河；河流
ship|n. 船；舰；v. 装运；把…装上船；使乘船；在船上工作
aeroplane|n. 飞机
fly|v. 飞翔；飞行；n. 苍蝇
sleep|n. 睡眠；v. 睡觉
shave|v. 刮；剃
cry|v. 哭；呼喊；n. 哭；呼喊
wash|v. 洗；洗涤
wait|v. 等待；等候；n. 等待；等候
jump|n. 跳；跳跃；v. 跳；跳跃
photograph|n. 照片；相片；v. 照相；拍照
village|n. 村庄；乡村
valley|n. 山谷；溪谷；流域
between|prep. （空间或时间上）在…之间；adv. （空间或时间上）介于…之间
hill|n. 丘陵；小山
another|adj. 又一个的；另一个的；pron. 又一；另一；不同的（一个）
wife|n. 妻子；太太
along|prep. 沿着；adv. 沿着
bank|n. 银行；岸
water|n. 水；v. 给…浇水；给（某地）供水
swim|v. 游泳
building|n. 建筑物；楼房；v. 建筑；“build”的现在分词
park|n. 公园；停车场；v. 停放；停车
into|prep. 进入；到…里
beside|prep. 在旁边（或附近）
off|prep. 离开；脱落；adv. 离；断开；int. 走开；adj. 远离的；空闲的
work|n. 工作；作品；活计；制作品；v. （使）工作；（使）运转；操作；经营；起作用
hard|adj. 坚硬的；困难的；费劲的；adv. 努力地
bookcase|n. 书架；书柜
hammer|n. 锤子；v. 锤打
paint|v. 刷油漆；画；绘；n. 油漆；绘画颜料
pink|n. 粉红色；adj. 粉红色的
favourite|adj. 特别受喜爱的；n. 特别喜爱的事物
homework|n. 家庭作业；功课
listen|v. 听
dish|n. 盘；碟；菜肴
front|n. 前面；前线；adj. 前面的
in front of|phrase. 在...前面
careful|adj. 小心的；仔细的
vase|n. 花瓶
drop|n. 滴；下落；v. 落下；掉下
flower|n. 花；花朵
show|v. 展示；表明；给...看；n. 演出；展览会；表现
send|v. 发送；送；寄
take|v. 拿；带领；乘坐；接受；花费；做（某个动作）
cheese|n. 奶酪
bread|n. 面包；生计
soap|n. 肥皂
chocolate|n. 巧克力；adj. 巧克力的
sugar|n. 糖；食糖；v. 在…中加糖
coffee|n. 咖啡
tea|n. 茶；茶叶；茶水
tobacco|n. 烟草；烟叶
bird|n. 鸟
any|adj. 任何的；；pron. 任何；adv. 稍微
some|adj. 一些；某些；pron. 有些；若干
of course|phrase. 当然
kettle|n. 水壶
behind|prep. 在…后面；adv. 在后面
teapot|n. 茶壶
now|adv. 现在；目前
find|v. 找；找到；发现；认为
boil|v. 沸腾；煮；煮沸；n. 煮沸；沸点
can|v. 能；n. 金属罐
boss|n. 老板
minute|n. 分钟；一会儿；adj. 微小的
ask|v. 问；询问；要求
handwriting|n. 笔迹；手写
terrible|adj. 可怕的；极坏的；糟糕的
lift|v. 举起；抬起；提起；解除；n. 电梯；搭便车
cake|n. 蛋糕；饼
biscuit|n. 饼干
like|v. 喜欢；prep. 像
want|v. 想要；n. 缺乏
fresh|adj. 新鲜的；新的；刚发生的；无经验的
egg|n. 蛋；鸡蛋
butter|n. 黄油；奶油；v. 涂黄油于...上
pure|adj. 纯的；纯净的；纯粹的
honey|n. 蜂蜜；甜蜜；宝贝
ripe|adj. 成熟的
banana|n. 香蕉
jam|n. 果酱；堵塞；困境；v. 挤紧；使堵塞；猛地做
sweet|adj. 甜的；悦人的
Scotch whisky|phrase. 苏格兰威士忌
choice|n. 选择；抉择；精选品；adj. 上等的；精选的
apple|n. 苹果
wine|n. 酒；果酒；葡萄酒；v. 用葡萄酒招待；（请）喝酒
beer|n. 啤酒
blackboard|n. 黑板
butcher|n. 屠夫；肉贩；v. 屠宰；杀戮；adj. 更男性化的；更有男子气的；“butch”的比较级
meat|n. 肉
beef|n. 牛肉
lamb|n. 羔羊；小羊；羔羊肉
husband|n. 丈夫；v. 节俭使用
steak|n. 牛排；肉排
mince|v. 切碎；剁碎；装腔作势地小步走；n. 绞碎的肉
chicken|n. 鸡肉；鸡
tell|v. 告诉；讲述；说；辨别
truth|n. 真理；事实；真实
either|adv. 也（用于否定词组后）；pron. 两者中的任何一个；（用于否定句）两者都不；conj. 两者之一
tomato|n. 西红柿；番茄
potato|n. 土豆；马铃薯
cabbage|n. 卷心菜
lettuce|n. 生菜；莴苣
pea|n. 豌豆
bean|n. 豆；豆科植物
pear|n. 梨子
grape|n. 葡萄
peach|n. 桃子；桃树；桃红色
Greece|n. 希腊
climate|n. 气候；（社会）风气；一般（社会）趋势
country|n. 国家；乡村
pleasant|adj. 令人愉快的；合意的；宜人的
weather|n. 天气；v. 使受风吹雨打；风干；经受住
spring|n. 春天；弹簧；泉；v. 跳；跃；蹦；突然猛烈地移动
windy|adj. 有风的；多风的；空谈的；吹牛的
warm|adj. 温暖的；v. （使）变暖
rain|n. 雨；雨水；v. 下雨
sometimes|adv. 有时；间或
summer|n. 夏季；夏天
autumn|n. 秋季；秋天
winter|n. 冬季；冬天
snow|v. 下雪；降雪；n. 雪花；雪
January|n. 一月
February|n. 二月
March|n. 三月
April|n. 四月
May|n. 五月
June|n. 六月
July|n. 七月
August|n. 八月
September|n. 九月
October|n. 十月
November|n. 十一月
December|n. 十二月
the U.S.|n. 美利坚合众国；“the United States”的缩写
Brazil|n. 巴西
Holland|n. 荷兰
England|n. 英格兰；英国
France|n. 法国
Germany|n. 德国
Italy|n. 意大利（欧洲国家）
Norway|n. 挪威
Russia|n. 俄罗斯
Spain|n. 西班牙（欧洲国家）
Sweden|n. 瑞典
mild|adj. 温和的；轻微的
always|adv. 总是；一直
north|n. 北方；adj. 北方的；adv. 在北方
east|n. 东方；adj. 东方的；adv. 在东方
wet|adj. 潮的；湿的；v. 使潮湿；把…弄湿
west|n. 西方；adj. 西方的；adv. 在西方
south|n. 南方；adj. 南方的；adv. 在南方
season|n. 季节；v. 给...调味；风干
best|adj. 最好的；最多的；最大的；“good”的最高级；adv. 最好地；最多地；最大地；“well”的最高级；n. 最高水平；最佳物；佼佼者
night|n. 夜晚；晚上
rise|v. 上升；提高；n. 上升；提高
early|adv. 提早地；adj. 早的；早前的
set|v. 设置；放置；使固定；n. 一组；一套；集合； adj. 固定的；位于…的；安排好的
late|adj. 晚的；迟的；已故的；adv. 晚；迟
interesting|adj. 有趣的
subject|n. 主题；话题；学科；对象
conversation|n. 谈话；会话；交谈
Australia|n. 澳大利亚；澳洲
Australian|adj. 澳大利亚的；澳大利亚人的；n. 澳大利亚人
Austria|n. 奥地利
Austrian|adj. 奥地利的；奥地利人的；n. 奥地利人
Canada|n. 加拿大
Canadian|n. 加拿大人；adj. 加拿大的；加拿大人的
China|n. 中国
Finland|n. 芬兰
Finnish|adj. 芬兰的；芬兰人的；芬兰语的；n. 芬兰人；芬兰语
India|n. 印度
Indian|adj. 印度的；印第安人的；n. 印度人；印第安人
Japan|n. 日本
Nigeria|n. 尼日利亚
Nigerian|adj. 尼日利亚的；尼日利亚人的；n. 尼日利亚人
Turkey|n. 土耳其
Turkish|adj. 土耳其的；土耳其人的；土耳其语的；n. 土耳其语；土耳其人
Korea|n. 韩国；朝鲜
Polish|adj. 波兰的；波兰人的；波兰语的；n. 波兰语；波兰人
Poland|n. 波兰
Thai|adj. 泰国的；泰国人的；泰语的；n. 泰国人；泰国语
Thailand|n. 泰国
live|v. 生活；居住；活着；adj. 活的；现场的；实况转播的
stay|v. 停留；保持；n. 停留；逗留
home|n. 家；家庭；adv. 在家；adj. 家的；家庭的；v. 送…回家；提供住处
housework|n. 家务事；家务劳动
lunch|n. 午餐；午饭
afternoon|n. 下午
usually|adv. 通常；一般
together|adv. 一起
evening|n. 晚上；傍晚
arrive|v. 到达；抵达
o'clock|adv. …点钟
shop|n. 商店；v. 购物
moment|n. 瞬间；片刻
envelope|n. 信封
writing paper|phrase. 信纸；书写纸
shop assistant|phrase. 售货员
size|n. 大小；尺码
pad|n. 垫；爪垫；便笺簿；v. 放轻脚步走
glue|n. 胶；胶水；v. 胶合；粘合；紧附于
chalk|n. 粉笔
change|n. 变化；变革；零钱；v. 变化；变革
feel|v. 感到；触摸；认为；n. 感受；触觉
look|v. 看；看上去；n. 看
call|n. 打电话；v. 叫；打电话
doctor|n. 医生；博士；v. 篡改
telephone|n. 电话；电话机
remember|v. 记得；记住
mouth|n. 嘴；口
tongue|n. 舌头；语言
bad|adj. 坏的；糟糕的；严重的
news|n. 新闻；消息
headache|n. 头痛；麻烦；令人头痛的人（或事物）
aspirin|n. 阿司匹林（镇痛解热消炎药）
earache|n. 耳痛
toothache|n. 牙痛
dentist|n. 牙科医生
stomach ache|phrase. 胃痛
medicine|n. 药；医学
temperature|n. 温度；气温；体温
flu|n. 流感；流行性感冒
measles|n. 麻疹
mumps|n. 腮腺炎
better|adj. 更好的；更优秀的；“good”的比较级；adv. 更好地；“well”的比较级；v. 胜过；使更佳
certainly|adv. 毫无疑问地；确定地；当然
get up|phrase. 起床
yet|adv. 还；然而；仍然；conj. 然而；但是
rich|adj. 富有的；富裕的；丰饶的；圆润的；油腻的
food|n. 食物
remain|v. 剩下；留下；保持
play|v. 玩；演奏；扮演；播放；n. 戏剧；比赛
match|n. 比赛；火柴；v. 相配
talk|v. 说话；交谈；n. 谈话
library|n. 图书馆
drive|v. 驾驶；驱使；n. 动力
so|adv. 如此；这么；很；也；conj. 所以
quickly|adv. 迅速地；快地
lean out of|phrase. 身体探出
break|v. 打破；打断；休息；n. 中断；休息；破裂
noise|n. 噪声；噪音
Dad|n. 爸爸；爹爹
key|n. 钥匙；关键；adj. 关键的
baby|n. 婴儿；宝贝
hear|v. 听；听见
enjoy|v. 享受；享有；喜爱
yourself|pron. 你自己
ourselves|pron. 我们自己
mum|adj. 沉默的；不说话的；n. 妈妈
myself|pron. 我自己
themselves|pron. 他们自己；她们自己；它们自己
himself|pron. 他自己
herself|pron. 她自己
greengrocer|n. 果菜商；蔬菜水果店
absent|adj. 缺席的；v. 缺席；不参加
Monday|n. 星期一
Tuesday|n. 星期二
Wednesday|n. 星期三
Thursday|n. 星期四
keep|v. 继续；保持；保留
spend|v. 花费；消耗；度过
weekend|n. 周末
Friday|n. 星期五
Saturday|n. 星期六
Sunday|n. 星期日
lucky|adj. 好运的；幸运的
church|n. 教堂
dairy|adj. 牛奶的；乳品的；n. 乳品店
baker|n. 面包师傅
grocer|n. 食品杂货商
year|n. 年
race|n. 种族；赛跑；竞争；v. 比赛；快速移动
town|n. 镇；城镇；市镇
crowd|n. 人群；群众；v. 拥挤；群集
stand|v. 站立；忍受；抵御；n. 停止；抵抗的状态；立足点
exciting|adj. 令人激动的；使人兴奋的；v. 使兴奋；使激动； “excite”的现在分词
just|adv. 只是；就；仅仅；刚刚；恰好；adj. 公正的；正当的；合理的
finish|v. 完成；结束
winner|n. 优胜者；成功者
way|n. 道路；方向；路线；方法；方式
stationer|n. 文具商
Denmark|n. 丹麦（北欧国家）
awful|adj. 可怕的；糟糕的；讨厌的；adv. 非常；极其
time|n. 时间；倍；次数；时期；v. 计时；安排时间；adj. 时间的；定时的；分期的
answer|n. 回答；答案；v. 回答；回应
last|adj. 最后的；最近的；adv. 最后；最近；v. 持续
phone|n. 电话；v. 打电话
again|adv. 再次；又一次
say|v. 说；讲；说话
week|n. 周；星期；礼拜
London|n. 伦敦（英国首都）
suddenly|adv. 突然；猛然；骤然
bus stop|phrase. 公共汽车站
smile|v. 微笑；n. 微笑；笑容
pleasantly|adv. 愉快地；快活地
understand|v. 理解
speak|v. 讲话；发言
hand|n. 手；v. 交；递；给
pocket|n. 口袋；衣袋；兜；v. 把…放进衣袋；adj. 袖珍的；小型的
phrasebook|n. 短语手册；常用语手册
phrase|n. 短语；词组；v. 叙述；措辞
slowly|adv. 缓慢地；迟缓地
hurriedly|adv. 匆忙地；仓促地
cut|v. 切；割；削减；n. 切；割；伤口；削减
thirstily|adv. 如饥似渴地
go|v. 走；去
greet|v. 问候；打招呼；迎接
ago|adv. 以前
buy|v. 买；换取；收买；相信
pair|n. 一双；一对；v. （使）成对；（使）配对
fashion|n. 时尚；流行；姿态；方式；v. 制作；把...塑造成；使适应
uncomfortable|adj. 使人不舒服的；感到难受的；不自在的
wear|v. 穿；戴；n. 衣着；磨损
appointment|n. 约会；约定；职位；任命
urgent|adj. 紧急的；紧迫的
till|prep. 直到；conj. 直到；n. 现金出纳机
shopping|n. 购物；所购买之物
list|n. 表；名单；v. 列出；（船）倾斜
vegetable|n. 蔬菜
need|n. 需要；v. 需要
hope|n. 希望；v. 希望
thing|n. 东西；事情
money|n. 钱；金钱
groceries|n. 食品杂货
fruit|n. 水果；成果；v. 结果实
stationery|n. 文具
newsagent|n. 报刊经销人
chemist|n. 化学家； 药剂师
bath|n. 洗澡；浴室；v. 给…洗澡
nearly|adv. 几乎；将近；差不多
ready|adj. 准备好的；v. 使...准备好
dinner|n. 晚餐；晚宴
restaurant|n. 餐厅；餐馆
roast|v. 烤；烘烤；n. 烤肉；烘烤；adj. 烤的；焙的
breakfast|n. 早餐；早饭
haircut|n. 理发；发型
party|n. 聚会；政党
holiday|n. 假日；假期
mess|n. 脏乱；杂乱；v. 弄糟；弄乱
pack|v. 包装；收拾行李；塞满；n. 包裹；小包；一群；（纸牌的）一副
suitcase|n. 手提箱
leave|v. 离开；离去；留下；n. 休假
already|adv. 已经
Paris|n. 巴黎（法国首都）
cinema|n. 电影院；电影
film|n. 电影；底片；薄薄的一层；v. 拍摄电影
beautiful|adj. 漂亮的
city|n. 城市
never|adv. 从未；决不
ever|adv. 在任何时候；总是
attendant|n. 服务人员；adj. 伴随的
bring|v. 带来；引起；导致
garage|n. 车库；汽车修理厂
crash|v. 碰撞；坠毁；崩溃；n. 碰撞；坠毁；崩溃
lamp-post|n. 灯杆；路灯柱
repair|v. 修理；修补；n. 修理；修补
try|n. 尝试；试图；v. 尝试；试图；努力
believe|v. 相信；认为；信任
may|auxv. 可能；可以；会；愿
how long|phrase. 多久
since|conj. 因为；由于；既然；从…以后；adv. 此后；后来；prep. 自…以后；从…以来
why|adv. 为什么；n. 为什么
sell|v. 出售；卖
because|conj. 因为
retire|v. 退休；退役
cost|v. 花费；n. 费用；代价
pound|n. 镑；英镑；v. 连续重击；捣碎
worth|n. 价值；adj. 有…价值；值得的
penny|n. 便士
still|adv. 仍然；还是；adj. 静止的；平静的
move|v. 移动；搬家；n. 行动；移动
miss|v. 想念；错过；漏掉；n. 错过；女士；小姐
neighbour|n. 邻居
person|n. 人；人员；个人
people|n. 人们；人；人民
poor|adj. 贫穷的；可怜的；缺少的；拙劣的
pilot|n. 飞行员；驾驶员
return|v. 返回；归还；n. 返回；归还
New York|n. 纽约
Tokyo|n. 东京（日本）
Madrid|n. 马德里（西班牙首都）
Athens|n. 雅典（希腊首都）
Berlin|n. 柏林（德国）
Bombay|n. 孟买
Geneva|n. 日内瓦（瑞士）
Moscow|n. 莫斯科（俄罗斯首都）
Rome|n. 罗马
Seoul|n. 汉城；首尔（韩国的首都和最大城市）
Stockholm|n. 斯德哥尔摩（瑞典首都）
Sydney|n. 悉尼（澳大利亚）
train|n. 火车；列车；列；队；v. 训练；培训
platform|n. 平台；站台；月台
plenty|adj. 足够的；n. 充裕；富裕
bar|n. 棒；条状物；（门、窗的）闩；酒吧；栅栏
station|n. 车站；站
porter|n. 行李搬运工；守门人；（列车卧车的）服务生
describe|v. 描述
zip|n. 拉链；精力；活力；v. 拉上拉链；快速移动；压缩
label|n. 标签；v. 用标签标明
handle|v. 处理；操纵；n. 柄；把手
address|n. 地址；网址；演说；v. 写上地址；向…讲话；解决
pence|n. 便士；“penny”的复数
belong|v. 应在（某处）；属于
ow|int. 哎哟（表示疼痛）
slip|v. 滑倒；滑落；溜走；悄悄地放；n. 滑倒；溜走；疏忽；纸片
fall|v. 下降；跌倒；n. 落下；跌落；秋天
downstairs|adv. 往楼下；在楼下；adj. 楼下的；底楼的
hurt|v. 受伤；感到疼痛；n. 伤痛
back|n. 背部；后面；adv. 回原处；向后；adj. 后面的；拖欠的；v. 支持
stand up|phrase. 站起来
help|n. 帮助；v. 帮助
at once|phrase. 马上
sure|adv. 当然；当然可以；确定；adj. 确信；必定的
X-ray|n. X射线
licence|n. 许可证；执照
Scotland|n. 苏格兰（英国）
card|n. 卡片；纸牌；银行卡
youth|n. 青春；年轻；青年
hostel|n. 旅社；招待所；（校外）学生宿舍
association|n. 协会；联系；联想
soon|adv. 很快；不久
write|v. 书写；写信；写作
exam|n. 考试；测验
pass|v. 路过；(时间)流逝；超过；传递；通过；n. (考试)及格；通行证
mathematics|n. 数学
question|n. 问题；疑问；v. 询问；怀疑
easy|adj. 容易的；轻松的
enough|adj. 足够的；充足的；adv. 足够地；充分地；n. 充足；足够；int. 够了
paper|n. 纸；报纸；论文；试卷；v. 用墙纸贴
fail|v. 失败；不及格；无法做到；使失望；衰退；倒闭；n. 失败；不及格
mark|n. 记号；痕迹；分数；v. 做标记；（使）留痕迹；评分
rest|v. （使）休息；（使）倚靠；停留在；中止；n. 休息；其他；剩余部分；宁静
difficult|adj. 困难的
hate|v. 讨厌；憎恨；n. 憎恨；厌恶
low|adv. 低；低矮；在低处；往下地；adj. 低沉的；低垂的
cheer|v. 欢呼；鼓舞；使鼓起精神；n. 欢呼声；激励
guy|n. 家伙；人
top|n. 顶；顶部；顶端；v. 胜过；超过；居…之首；adj. 最高的；极棒的
clever|adj. 聪明的；灵巧的
stupid|adj. 愚蠢的；笨的
cheap|adj. 便宜的；廉价的
expensive|adj. 昂贵的
stale|adj. 不新鲜的；陈腐的
loud|adj. 响亮的；大声的；adv. 大声地；响亮地
high|adj. 高的；adv. 在高处
soft|adj. 软的；柔软的
sour|adj. 酸的；不友好的；坏脾气的；v. （使）变酸
spell|v. 拼写；招致；意味着；顶替；n. 一段时间；咒语；魅力
intelligent|adj. 有才智的；聪明的；明智的
mistake|n. 错误；失误；v. 弄错；误解
present|n. 目前；礼物；adj. 在场的；目前的；v. 呈现；提出
dictionary|n. 词典；字典
carry|v. 拿；携带；运送
correct|adj. 正确的；v. 改正；修正
madam|n. 夫人；女士；非常自我的女子
as well|phrase. 也；同样；又；还
pretty|adv. 很；相当；adj. 漂亮的
idea|n. 主意；想法；理念
a little|phrase. 少量；少许
teaspoonful|n. 一茶匙的量
less|adv. 较少地；更少地；“little”的比较级；adj. 更少的；“little”的比较级；pron. 较少；更少
a few|phrase. 少许；少数
pity|v. 怜悯；同情；n. 怜悯；同情；憾事
instead|adv. 代替；反而
advice|n. 建议；意见
most|adj. 最多的；大多数的；adv. 最；pron. 大部分
least|adj. 最少的；最小的；“little”的最高级；adv. 最小；最少；“little”的最高级；n. 最小；最少
worse|adv. 更糟；更坏；adj. 更坏的；更糟糕的；“bad”的比较级；“ill”的比较级
worst|adv. 最坏；最严重；最糟；adj. 最坏的；最糟糕的；“bad”的最高级；“ill”的最高级；n. 最坏的事
model|n. 模型；模特儿；模范；型号；v. 将…做成模型；当模特儿
afford|v. 买得起；担负得起；有时间做；给予
deposit|n. 存款；押金；沉淀；v. 存储；堆积
instalment|n. 部分；分期付款；分期连载的一部分
price|n. 价格；代价；v. 定价
millionaire|n. 百万富翁
conductor|n. 指挥；售票员；导体
fare|n. 车费；票价；费用；v. 进展；成功（或不成功等）
note|n. 笔记；便条；注释；音调；语气；钞票；v. 注意；备注；记录
passenger|n. 旅客；乘客
none|pron. 没有一个；adv. 绝无
neither|adj. 两者都不的；pron. 两者都不；adv. 两者都不；conj. 也不
get off|phrase. 下车；离开
tramp|n. 流浪汉；流浪乞丐；徒步旅行；v. 步行；踩；踏
except|conj. 除了；只是；v. 不计；把…除外；prep. 除了；除外
anyone|pron. 任何人
knock|v. 敲；撞；击；打；n. 撞击；敲击
everything|pron. 每件事；一切事物
quiet|adj. 安静的
impossible|adj. 不可能的
invite|v. 邀请；招致
anything|pron. 任何东西；任何事
nothing|pron. 没有什么；n. 无
lemonade|n. 柠檬汽水；柠檬饮料
joke|n. 笑话；玩笑；v. 开玩笑
asleep|adj. 睡着的
glasses|n. 眼镜；n. 玻璃；玻璃杯；“glass”的复数
dining room|phrase. （家里或宾馆的）餐厅
coin|n. 硬币；金属钱币；v. 铸造硬币；杜撰；创造
swallow|v. 吞咽；轻信；n. 燕子；吞咽
later|adv. 后来；稍后；adj. 后来的；稍后的；晚些的；晚年的
toilet|n. 厕所；马桶；卫生间；盥洗室
ring|n. 环；环形物；戒指；铃声；声调；拳击场；v. 成环形；环绕；响铃；鸣；给…打电话
story|n. 故事；小说； 轶事；假话
happen|v. 发生
thief|n. 小偷；贼；窃贼
enter|v. 进入；进去
dark|adj. 黑暗的；暗色的；深色的；n. 黑暗；夜；暗色
torch|n. 火炬；手电筒；火把
voice|n. 声音；呼声；意见；v. 表达；发嗓音
parrot|n. 鹦鹉；学舌者；v. 鹦鹉学舌地说；机械地模仿
exercise book|phrase. 练习册；作业本
customer|n. 客户；顾客；主顾
forget|v. 忘记；遗忘
manager|n. 经理；管理者
serve|v. 服务；接待；供职；服役
counter|n. 柜台；对立面；v. 反驳；抵消；adv. 相反地
recognize|v. 认出；意识到；承认
road|n. 道路；公路
during|prep. 在…期间
trip|n. 旅行；旅程；v. 绊倒；出差错；轻快地走
travel|v. 旅游；旅行；n. 旅游；旅行
offer|n. 提议；提供；报价；v. 提供；愿意
guess|v. 猜测；猜想；n. 猜测；猜想
grow|v. 生长；成长；种植；渐渐变成
beard|n. 胡须；络腮胡子；v. 公然反抗
kitten|n. 小猫
terribly|adv. 可怕地；非常；极
dry|adj. 干的；v. 变干
nuisance|n. 讨厌的人；讨厌的事
mean|v. 意思是；打算；导致；有意；对…严肃认真；adj. 低劣的；吝啬的；平均的；n. 平均数；中庸；居中
surprise|v. 使惊奇；使感到意外；n. 惊讶；惊喜；意外
immediately|adv. 立即；马上；conj. 即刻
famous|adj. 著名的；出名的
actress|n. 女演员
at least|phrase. 至少；不少于；起码
actor|n. 演员；男演员
wave|n. 波；波浪；海浪；挥手；v. 挥手；挥舞；招手；起伏
track|n. 轨道；踪迹；小路；跑道；v. 追踪；跟踪
mile|n. 英里
overtake|v. 赶上；超过
speed limit|phrase. 速度限制
dream|n. 梦；梦想；v. 梦想；做梦
sign|n. 标志；符号；告示牌；手势；征兆；v. 签名；做标记
driving licence|n. 驾驶执照
charge|v. 使承担责任；收费；充电；指控；给…充电；n. 负责；收费；指控；谴责
darling|n. 心爱的人；adj. 亲爱的
Egypt|n. 埃及（东北非国家）
abroad|adv. 在国外；出国
worry|v. 担心；担忧；n. 担心；忧虑
reporter|n. 记者；通讯员
sensational|adj. 轰动的；耸人听闻的；极好的
mink coat|phrase. 貂皮大衣
future|n. 未来；将来；前途；adj. 将来的；未来的
get married|phrase. 结婚
hotel|n. 旅馆；酒店；饭店
latest|n. 最新消息；最新事物；adj. 最新的；最近的；最后的；“late”的最高级
introduce|v. 介绍；引进
football|n. [英]足球；[美]橄榄球
pool|n. 水塘；水池；美式撞球；备用物资；v. 合伙经营；共用；汇集
win|v. 赢；获得；n. 胜利；赢得
world|n. 世界
depend|v. 依靠；依赖；取决于
extra|adj. 额外的；adv. 额外地；n. 额外的事物
overseas|adj. 外国的；海外的；adv. 在国外；在海外
engineering|n. 工程；工程学
company|n. 公司；陪伴
line|n. 行；列；线；界线
excited|adj. 激动的；兴奋的；v. 使兴奋；使激动；“excite”的过去式和过去分词
get on|phrase. 进展；相处；上车
middle-aged|adj. 中年的
opposite|n. 反面；对立面；adj. 对面的；prep. 与…相对；adv. 在相反的位置
curiously|adv. 好奇地；奇异地；奇怪地
funny|adj. 滑稽的；好笑的；有趣的
powder|n. 粉末；粉；v. 搽粉于；使成粉末
compact|adj. 紧密的；小型的；n. 协定；小型汽车；化妆粉盒
kindly|adv. 亲切地；和善地；请；adj. 仁慈的；厚道的
ugly|adj. 丑陋的；难看的
amused|adj. 被逗乐的；v. 逗乐；娱乐；消遣；“amuse”的过去式和过去分词
embarrassed|adj. 尴尬的；窘迫的；v. 使窘迫；使尴尬；“embarrass”的过去式和过去分词
worried|adj. 担忧的；焦虑的；发愁的；v. 担心；担忧；“worry”的过去式和过去分词
regularly|adv. 有规律地；定期地；经常地
surround|v. 环绕；围绕
wood|n. 木材；木头；树林
beauty spot|phrase. 风景点；美人痣
hundred|num. 百；一百
through|prep. 通过；穿过；adv. 彻底；从头到尾地；adj. 全程的；直通的
visitor|n. 客人；参观者
tidy|adj. 整洁的；整齐的；v. 收拾；整理
litter|n. 垃圾；杂物；一窝小崽；担架；v. 乱扔；乱丢杂物
litter basket|phrase. 废物筐
place|n. 地方；方位；v. 安置；安放
throw|v. 扔；抛；丢；投；n. 扔；抛；摔；投
rubbish|n. 垃圾；废物
count|v. 计算；清点；看作；有价值；n. 计数；计算
cover|v. 遮盖；包括；报道；n. 封面；遮盖物；庇护所
piece|n. 片；块；件；作品；v. 拼凑
tyre|n. 轮胎
rusty|adj. 生锈的；生疏的
among|prep. 在…之间
prosecute|v. 起诉；控告；检举；指控；继续从
