private|adj. 私人的
conversation|n. 谈话；会话；交谈
theatre|n. 剧场；电影院
seat|n. 座位；v. 使坐下
play|v. 玩；演奏；扮演；播放；n. 戏剧；比赛
loudly|adv. 大声地；高声地
angry|adj. 生气的；愤怒的
angrily|adv. 生气地；愤怒地
attention|n. 注意；关注；照料
bear|n. 熊；v. 负荷；带有；忍受；承受；生（孩子）
business|n. 生意；商业；事务
rudely|adv. 粗鲁地；无礼地
until|prep. 到…时；直到…为止；conj. 到…时；直到…为止
outside|adv. 在外面；n. 外面；外边；外部；prep. 在...外；adj. 外面的；外界的
ring|n. 环；环形物；戒指；铃声；声调；拳击场；v. 成环形；环绕；响铃；鸣；给…打电话
aunt|n. 姑；婶；姨；伯母
repeat|v. 重复；重做；n. 重复；重做
send|v. 发送；送；寄
postcard|n. 明信片
spoil|v. 宠坏；搞糟；变质；n. 赃物；战利品
museum|n. 博物馆
public|adj. 平民的；大众的；公众的；n. 公众；公共场所
friendly|adj. 友好的
waiter|n. 服务员；侍者
lend|v. 借给；借出；贷（款）
decision|n. 决定；抉择；选择
whole|n. 整个；全部；adj. 全部的；整体的
single|adj. 单一的；单独的；单身的；n. 单曲（唱片）；v. 挑选
exciting|adj. 令人激动的；使人兴奋的；v. 使兴奋；使激动； “excite”的现在分词
receive|v. 接收；收到
firm|n. 公司；商行；adj. 坚固的；结实的
different|adj. 不同的
centre|n. 中心；中央；v. 放在…中央
abroad|adv. 在国外；出国
pigeon|n. 鸽子
message|n. 消息；信息；要旨；要点；v. 给…发消息；给…留言
cover|v. 遮盖；包括；报道；n. 封面；遮盖物；庇护所
distance|n. 距离；远处；v. 保持距离
request|n. 请求；要求的事；v. 要求；请求
spare part|n. 备件
service|n. 服务；v. 保养；维修
beggar|n. 乞丐
food|n. 食物
pocket|n. 口袋；衣袋；兜；v. 把…放进衣袋；adj. 袖珍的；小型的
call|n. 打电话；v. 叫；打电话
detective|n. 侦探；adj. 侦探的
airport|n. 机场；航空港
expect|v. 期待；期望；预期
valuable|adj. 有价值的；贵重的；值钱的
parcel|n. 包裹；小包；v. 捆扎；打包
diamond|n. 钻石；菱形；金刚石
steal|v. 偷；窃取
main|adj. 主要的；最重要的
airfield|n. 飞机场
guard|n. 保卫；警卫；v. 守卫；警戒
precious|adj. 珍贵的；宝贵的
stone|n. 石头；石块；v. 用石头打
sand|n. 沙；v. 打磨
competition|n. 竞争；比赛
neat|adj. 整洁的；整齐的；有条理的
path|n. 道路；小路；小径
wooden|adj. 木制的；木头的；生硬笨拙的
pool|n. 水塘；水池；美式撞球；备用物资；v. 合伙经营；共用；汇集
welcome|n. 欢迎；v. 欢迎；int. 欢迎
crowd|n. 人群；群众；v. 拥挤；群集
gather|v. 聚集；集合
hand|n. 手；v. 交；递；给
shout|v. 大叫；喊叫；n. 喊叫声
refuse|v. 拒绝；不接受；n. 废料；垃圾；废物
laugh|v. 笑；发笑；n. 笑；笑声
jazz|n. 爵士乐
musical|adj. 音乐的；擅长音乐的；喜欢音乐的；悦耳的；n. 音乐剧；音乐歌舞片
instrument|n. 仪器；乐器；工具；手段；法律文件
clavichord|n. 古钢琴
recently|adv. 最近；近来
damage|v. 损害；破坏；n. 损害；破损
key|n. 钥匙；关键；adj. 关键的
string|n. 弦；线；一连串
shock|n. 震惊；震动；冲击；电击；休克；浓密的头发；v. 使震惊；使震动；adj. 浓密的
allow|v. 允许；准许；给予；留出；同意；承认
touch|v. 触摸；接触；触动；n. 触摸；触觉；触感
turn|v. 转身；转弯；转动；转变；n. 轮到的机会；拐弯；转变
deserve|v. 值得；应得
lawyer|n. 律师
bank|n. 银行；岸
salary|n. 薪金
immediately|adv. 立即；马上；conj. 即刻
luck|n. 运气；好运；幸运
captain|n. 队长；船长；v. 指挥
sail|v. 航行；驾（船）；n. 帆；航行；航海
harbour|n. 海港；v. 庇护；窝藏
proud|adj. 自豪的；骄傲的
important|adj. 重要的
group|n. 组；集团；群；v. （使）形成组；成群
pop singer|phrase. 流行歌手
club|n. 俱乐部；棍子；v. 用棍棒打
performance|n. 表演；表现；性能；履行；执行
occasion|n. 特殊场合；时机；机会；理由；需要；v. 导致；使发生
amusing|adj. 逗人笑的；有乐趣的；好笑的；v. 逗乐；娱乐；消遣；“amuse”的现在分词
experience|v. 经历；体验；n. 经验；阅历
wave|n. 波；波浪；海浪；挥手；v. 挥手；挥舞；招手；起伏
lift|v. 举起；抬起；提起；解除；n. 电梯；搭便车
reply|v. 答复；回答；n. 答复；回答
language|n. 语言
journey|n. 旅行；旅程
secretary|n. 秘书；大臣
nervous|adj. 担忧的；焦虑的；紧张不安的；神经系统的
afford|v. 买得起；担负得起；有时间做；给予
weak|adj. 虚弱的；无力的
interrupt|v. 打断；打扰；打岔
park|n. 公园；停车场；v. 停放；停车
traffic|n. 交通；流量；非法交易；v. 非法买卖
ticket|n. 票；车票
note|n. 笔记；便条；注释；音调；语气；钞票；v. 注意；备注；记录
area|n. 面积；区域
sign|n. 标志；符号；告示牌；手势；征兆；v. 签名；做标记
reminder|n. 提醒人的事物；通知单；提示信
fail|v. 失败；不及格；无法做到；使失望；衰退；倒闭；n. 失败；不及格
obey|v. 遵守；服从
appear|v. 出现；似乎；显得
stage|n. 阶段；时期；舞台；v. 举行；上演
bright|adj. 明亮的；鲜艳的；聪明的
stocking|n. 长袜
sock|n. 短袜
pub|n. 酒吧；酒馆
landlord|n. 地主；房东
bill|n. 账单；钞票；议案；v. 给…开账单
hurry|n. 匆忙；仓促；v. 抓紧；赶快；匆忙地做
ticket office|phrase. 票房；售票处
pity|v. 怜悯；同情；n. 怜悯；同情；憾事
exclaim|v. 呼喊；大叫
return|v. 返回；归还；n. 返回；归还
sadly|adv. 伤心地；难过地
catch|v. 捕捉；接住；抓住；赶上；得病；理解；n. 捕捉；搭扣；钩；抛接球游戏
fisherman|n. 渔夫
boot|n. 靴子；长筒靴
waste|n. 垃圾；废物；浪费；v. 浪费；白费；糟蹋；adj. 荒芜的；废弃的；丢弃的
realize|v. 实现；认识到；意识到；变卖
mad|adj. 发疯的；疯狂的；生气的
reason|n. 原因；理由；理性；v. 推理；推断；讲道理；思考
sum|n. 总数；算术；金额；v. 概括
determined|adj.  坚决的；坚定的；有决心的；v. 决心；决定；“determine”的过去式和过去分词
dream|n. 梦；梦想；v. 梦想；做梦
age|n. 年龄；时代；v. 变老
channel|n. 河床；海峡；（水）槽；渠道；频道；途径；v. 引导；开导；形成河道
throw|v. 扔；抛；丢；投；n. 扔；抛；摔；投
complete|adj. 完整的；完成的；v. 完成；使完整
modern|adj. 现代的；时髦的
strange|adj. 奇怪的；陌生的
district|n. 地区；区域；行政区
manager|n. 经理；管理者
upset|v. 推翻；打乱；使心烦；adj. 沮丧的；难过的；不安的
sympathetic|adj. 同情的
complain|v. 抱怨；投诉
wicked|adj. 邪恶的；缺德的；淘气的
contain|v. 包含；容纳；克制；遏制
honesty|n. 诚实；正直；老实
railway|n. 铁路
porter|n. 行李搬运工；守门人；（列车卧车的）服务生
several|pron. 几个；一些；adj. 不同的；各自的
foreigner|n. 外国人；外来人
wonder|n. 惊奇；奇迹；v. 惊讶；想知道；怀疑
art|n. 艺术
critic|n. 评论家；批评者
paint|v. 刷油漆；画；绘；n. 油漆；绘画颜料
pretend|v. 假装；佯装；自称
pattern|n. 模式；图案；样式；v. 形成图案；仿造
curtain|n. 帷幕；窗帘
material|n. 材料；原料；adj. 物质的
appreciate|v. 欣赏；理解；感激；增值
notice|n. 注意；通知；v. 注意；留心；通知
whether|conj. 是否；不管；无论
hang|v. 悬挂；吊；绞死；n. 悬挂；绞刑
critically|adv. 批评地；危急地；严重地
upside down|phrase. 颠倒；乱七八糟
tent|n. 帐篷；帐棚
field|n. 田地；领域；场地；运动场；v. 处理，应付（问题、电话等）
smell|n. 闻；气味；嗅觉；v. 嗅；闻；散发气味；察觉
wonderful|adj. 精彩的；极好的
campfire|n. 营火；篝火
creep|v. 爬行；匍匐；蹑手蹑脚地走；汗毛直竖；n. 讨厌鬼；马屁精
sleeping bag|phrase. 睡袋
comfortable|adj. 舒服的；安逸的
soundly|adv. 酣（睡）；明智地；可靠地；完全地
leap|v. 跳跃；n. 跳跃
heavily|adv. 沉重地；猛烈地
stream|n. 流；溪；v. 流；流动
form|n. 形式；表格；形状；v. 组成；建立
wind|n. 风；v. 蜿蜒；缠绕
right|adj. 右边的；正确的；n. 权利；右边；adv. 正确地；直接地；向右；v. 扶直；纠正
rare|adj. 稀少的；珍奇的
ancient|adj. 古代的；古老的；n. 古人
myth|n. 神话；虚构故事；错误观念；荒诞说法
trouble|n. 麻烦；问题；困难；v. 使烦恼；苦恼；费神
effect|n. 影响；作用；效果；效应；v. 引起；实现；使生效
Medusa|n. 美杜莎（古希腊神话中3位蛇发女怪之一）
Gorgon|n. 戈耳工（古希腊神话中三个蛇发女怪之一）
taxi|n. 出租车；计程车；v. 乘坐出租汽车
Pilatus Porter|n. 皮勒特斯·波特（飞机机名）
land|n. 土地；陆地；v. 降落；着陆
plough|n. 犁；耕地；v. 犁（田）；耕（地）；翻（土）
lonely|adj. 孤独的；寂寞的；偏僻的
Welsh|adj. 威尔士的；威尔士人的；威尔士语的；n. 威尔士语；威尔士人
roof|n. 屋顶；顶部；v. 给…盖顶
block|n. 块；街区；大楼；大厦；障碍物；v. 阻塞；阻碍
flat|adj. 平坦的；扁平的；平淡无味的；（说话）断然的；（轮胎）瘪了的；n. 公寓；平坦部分；adv. 直接地
desert|n. 沙漠；荒漠；v. 抛弃
polo|n. 马球；水球（运动）
Wayle|n. 威尔河
cut|v. 切；割；削减；n. 切；割；伤口；削减
row|n. 排；划船；吵闹；v. 划船；吵架
kick|n. 踢；踹；v. 踢；踹
towards|prep. 向；朝；关于
nearly|adv. 几乎；将近；差不多
sight|n. 看见；景象；视力；v. 看到；观测
retire|v. 退休；退役
company|n. 公司；陪伴
bicycle|n. 自行车；脚踏车
save|v. 保存；节省；拯救；prep. 除...之外；除了；conj. 若不是；除了
workshop|n. 车间；工场；研讨会
helper|n. 帮助者；助手；帮手
employ|v. 雇佣；使用
grandson|n. 孙子；外孙子
once|adv. 一次；曾经；conj. 一旦；一…便；n. 一次；adj. 从前的
temptation|n. 诱惑
article|n. 文章；物品；项目；条款；冠词
wrap|v. 包；缠绕；覆盖；穿外衣；遮蔽；n. 外套；围巾；包裹；包装材料
simply|adv. 简单地；仅仅；简直
arrest|v. 逮捕；拘留；阻止；吸引；n. 逮捕；拘捕
darkness|n. 黑暗；阴暗
explain|v. 解释；说明；阐明
coast|n. 海岸；海滨
storm|n. 暴风雨；雷暴雨
rock|n. 岩石；摇滚乐；v. （使）摇动；震撼；（使）摇晃
shore|n. 岸；滨
light|n. 光；灯；光线；adj. 轻的；浅的；明亮的；少量的；v. 点燃；照亮
ahead|adv. 提前；在前
cliff|n. 悬崖；峭壁
struggle|v. 斗争；挣扎；抗争；n. 斗争；奋斗；抗争
hospital|n. 医院
station|n. 车站；站
most|adj. 最多的；大多数的；adv. 最；pron. 大部分
while|conj. 当…的时候；尽管；然而；n. 一会儿；一段时间
regret|n. 遗憾；痛惜；v. 懊悔；惋惜
far|adv. 远；极；adj. 较远的；遥远的
rush|v. 冲；赶忙做；催促；n. 冲；匆忙
act|v. 行动；表现；演戏；n. 行动；装模作样；（戏）幕；法令
straight|adj. 直的；笔直的；正直的；率直的；adv. 直；径直；直接
fright|n. 惊吓；恐怖；惊骇
battered|adj. 破旧不堪的；受虐待的；v. 连续猛击；殴打；严重破坏；“batter”的过去式和过去分词
shortly|adv. 不久；马上；简短地
afterwards|adv. 后来；然后
record|n. 记录；唱片；v. 记录；录制
strong|adj. 强壮的；强烈的
swimmer|n. 游泳运动员；游泳者
succeed|v. 成功；继承
train|n. 火车；列车；列；队；v. 训练；培训
anxiously|adv. 焦急地；忧虑地
intend|v. 打算；计划
solid|n. 固体；立体图形；adj. 固体的；坚固的；可靠的
Olympic|adj. 奥林匹克的
hold|v. 举行；持有；保留；抓住；容纳；n. 拿；持；控制
government|n. 政府；治理；统治
immense|adj. 巨大的
stadium|n. 体育场；运动场
standard|n. 标准；adj. 标准的；规范的；权威的
capital|n. 首都；资本；省会
fantastic|adj. 奇异的；极好的；奇妙的
design|v. 设计；计划；谋划；构思；n. 设计；图案；花样；企图；图谋
except|conj. 除了；只是；v. 不计；把…除外；prep. 除了；除外
Mediterranean|n. 地中海；adj. 地中海的
continually|adv. 连续不断地
bitterly|adv. 痛苦地；刺骨地；激烈地；极其地
sunshine|n. 阳光
operation|n. 操作；运行；手术
successful|adj. 成功的；有成就的
following|adj. 接着的；下列的；v. 跟随；“follow”的现在分词；n. 追随者；下列各项；prep. 在...之后
patient|adj. 有耐心的；n. 病人
alone|adj. 独自的；孤独的；adv. 独自；单独
exchange|n. 交换；交易所；兑换；v. 交换；兑换
inquire|v. 询问；调查
certain|adj. 确定的；一定的；某个；一定程度上的
caller|n. 来访者；打电话者
relative|n. 亲戚；adj. 比较的；相对的；相关联的
hostess|n. 女主人；女房东；女招待；女主持人
unsmiling|adj. 不笑的；不苟言笑的；严肃的
tight|adj. 紧的；adv. 紧紧地
fix|v. 修理；固定；确定
globe|n. 球体；地球
despair|v. 绝望；n. 绝望
rude|adj. 粗鲁的；无礼的
mirror|n. 镜子；v. 反射；反映
hole|n. 孔；洞
remark|v. 评论；谈论；注意到；n. 评述；言论；注意
remind|v. 提醒；使想起
lighthouse|n. 灯塔
market|n. 市场；商场；销路；行情；v. 在市场上交易；营销
snake charmer|phrase. 耍蛇者
pipe|n. 管子；管道；烟斗；v. 吹笛；以管输送
tune|v. 调整；调音；n. 曲调；调子
glimpse|v. 瞥见；n. 一瞥
snake|n. 蛇；v. 蛇行；曲折前行
movement|n. 活动；运动；动作；乐章
continue|v. 继续；连续
dance|n. 舞蹈；v. 跳舞
obviously|adv. 显然；明显地
difference|n. 差异；不同
Indian|adj. 印度的；印第安人的；n. 印度人；印第安人
pole|n. 柱；杆；地极
flight|n. 飞行；航班；鸟群；（阶梯的）一段
explorer|n. 探险者；勘探者
lie|v. 躺；撒谎；欺骗；n. 谎言
serious|adj. 严肃的；严重的；庄重的；认真的
point|n. 点；观点；要点；分数；v. 指向；指出；弄尖；瞄准
seem|v. 似乎；好像；看起来
crash|v. 碰撞；坠毁；崩溃；n. 碰撞；坠毁；崩溃
sack|n. 袋子；解雇；v. 解雇；装入袋子；劫掠
clear|adj. 清楚的；明确的；清晰的；清澈的；晴朗的；v. 清空；清除；放晴；使明确；adv. 清楚地；彻底地
aircraft|n. 航空器；飞行器
endless|adj. 无穷的；无尽的
plain|n. 平原；adj. 简单明了的；朴素的
forest|n. 森林
risk|n. 风险；v. 冒...的危险
picnic|n. 野餐；v. 去野餐
edge|n. 边缘；边沿；锋；刃；锋利；优势；v. 使锋利；使侧着移动
strap|n. 带子；皮带；皮条；v. 用带缚住；包扎
possession|n. 拥有；财产
breath|n. 呼吸；气息
content|n. 内容；含量；目录；adj. 满足的；v. 使满意
mend|v. 修理；修补；康复；n. 修补；补丁；痊愈
conscience|n. 良心；良知
wallet|n. 钱包；皮夹；钱夹
savings|n. 存款； 储蓄金；n. 节约；“saving”的复数
villager|n. 村民；乡村居民；乡下人
per cent|n. 百分之…
unload|v. 卸载；卸下
extremely|adv. 非常地；极其地；极端地
occur|v. 发生；出现
astonish|v. 使惊讶
pile|n. 桩；堆；摞；v. 堆放；叠放
woollen|adj. 毛纺的；羊毛的；n. 毛线；毛织品
goods|n. 商品；货物
discover|v. 发现；查明；发觉
admit|v. 承认；允许进入
confine|v. 限制；监禁
normal|adj. 正常的；一般的
thirsty|adj. 口渴的；渴望的
ghost|n. 鬼；幽灵
haunt|v. 出没；萦绕；长期困扰；常去；n. 常到之地
furniture|n. 家具
whisky|n. 威士忌
suggest|v. 建议；提出；使想起；暗示
shake|v. 摇动；颤动；n. 摇动；颤动
accept|v. 接受；认可；同意
pull|v. 拉；拖；牵；拔；n. 拉；拖；牵；拔
cotton wool|phrase. 棉絮；药棉
collect|v. 收集
collection|n. 收集物；收藏品
nod|v. 点头；打盹；n. 点头
meanwhile|adv. 与此同时；在此期间
tired|adj. 疲倦的；厌烦的；v. 使疲倦；使厌烦；“tire”的过去式和过去分词
real|adj. 真实的；真的；真正的
owner|n. 所有权人；主人；物主
spring|n. 春天；弹簧；泉；v. 跳；跃；蹦；突然猛烈地移动
mattress|n. 褥垫；床垫
gust|n. 一阵狂风；突然的一阵；v. （风）猛刮
sweep|v. 扫；打扫；掠过；扫荡；n. 扫；打扫；掠过；席卷
courtyard|n. 庭院；院子
smash|v. 打碎；猛烈撞击；n. 打碎；破碎的哗啦声；撞车事故
miraculously|adv. 奇迹般地；神奇地；非凡地
unhurt|adj. 未受伤的；安然无恙的
glance|v. 扫视；瞥一眼；浏览；n. 一瞥；扫视
promptly|adv. 马上；迅速地；敏捷地；准时地
ride|v. 骑；乘坐；n. 骑；乘坐
excursion|n. 远足；短途旅行；涉猎某事
conductor|n. 指挥；售票员；导体
view|n. 视野；风景；见解；v. 审视；观看
reward|n. 奖励；报酬；v. 奖励；回报
virtue|n. 美德；优点
diet|n. 日常饮食；v. 节制饮食
forbid|v. 禁止；不准
hurriedly|adv. 匆忙地；仓促地
embarrass|v. 使窘迫；使尴尬
guiltily|adv. 内疚地；有罪地
strict|adj. 严格的；严厉的
occasionally|adv. 偶尔；有时
temporarily|adv. 暂时地；临时地
inch|n. 英寸；尺寸；少量
space|n. 空间；太空；空格；空白；v. 以一定间隔排列
actually|adv. 事实上；实际上；竟然
hot|adj. 热的
fireman|n. 消防队员
cause|n. 原因；理由；理想；事业；v. 导致；引起
examine|v. 检验；审查；调查
accidentally|adv. 意外地
remains|n. 遗迹；残余；遗体；v. 剩下；留下；依然不变；“remain”的第三人称单数
wire|n. 金属丝；电线；电报；v. 发电报；装电线
volt|n. 伏特
power line|phrase. 电力线；输电线；电源线
solve|v. 解决；解答
mystery|n. 谜；难以理解的事物；神秘感
snatch|v. 攫取；夺取；抓住；n. 攫取；夺取；抓住
spark|n. 火花；火星；v. 触发；冒火花；闪光；激发
sticky|adj. 黏的；棘手的
finger|n. 手指
pie|n. 果馅饼
mix|v. 混合；掺入；合成；交往；n. 混合；结合
pastry|n. 糕点；馅饼皮
annoying|adj. 使恼怒的；讨厌的；v. 使烦恼；使气恼；“annoy”的现在分词
receiver|n. 听筒；接收者
dismay|n. （因惊愕）沮丧；失望；v. 使惊愕、沮丧
recognize|v. 认出；意识到；承认
persuade|v. 说服；劝说
mess|n. 脏乱；杂乱；v. 弄糟；弄乱
doorknob|n. 球形门拉手
register|v. 注册；登记；n. 登记簿；现金出纳机
gold|n. 金；金币；金黄色；adj. 金色的
mine|n. 矿；地雷；pron. 我的（东西）；v. 采矿；埋地雷
treasure|n. 财富；珍宝；宝物；v. 珍爱；珍惜；珍藏
revealer|n. 探测器
invent|v. 发明；创造
detect|v. 察觉；查出；测出
bury|v. 埋葬；埋藏
cave|n. 洞穴
seashore|n. 海岸；海滨；海边
pirate|n. 海盗；盗版者；v. 抢劫；剽窃；盗印
arm|n. 手臂；v. 武装
soil|n. 土壤
entrance|n. 入口；进入；到场；v. 使出神；使入迷
finally|adv. 最后；终于
worthless|adj. 无价值的
thoroughly|adv. 彻底地；完全地
trunk|n. 树干；躯干；大衣箱；象鼻子
confident|adj. 自信的；确信的
value|n. 价值；（数）值；v. 估价；重视
sound|n. 声音；声响；v. 响；听起来；adj. 健全的；完好的；合理的；可靠的；酣睡的
excitement|n. 兴奋；激动
handsome|adj. 英俊的；丰厚的
Rolls-Royce|n. 劳斯莱斯牌汽车
Benz|n. 奔驰牌汽车
wheel|n. 车轮；v. 转动
explosion|n. 爆炸；（感情）爆发；激增
course|n. 课程；过程；一道菜；v. 快速流动；（思想或感情）涌动
rival|n. 竞争者；敌手；v. 竞争；相匹敌
speed|n. 速度；速率；v. 加速；加快
downhill|adv. 向下；走下坡；adj. 下山的；下坡的
madam|n. 夫人；女士；非常自我的女子
jeans|n. 牛仔裤
hesitate|v. 犹豫；踌躇
serve|v. 服务；接待；供职；服役
scornfully|adv. 轻蔑地；藐视地
punish|v. 惩罚；处罚
fur|n. 毛皮；皮草；软毛
eager|adj. 热切的；渴望的
blessing|n. 祝福；祷告；幸事；批准；v. 祝福；保佑；“bless”的现在分词
disguise|v. 伪装；掩饰；n. 伪装；伪装物
tiny|adj. 极小的；微小的；微量的
possess|v. 拥有；占有
cursed|adj. 被诅咒的；可恶的；v. 诅咒；咒骂；“curse”的过去式和过去分词
increase|n. 增加；增长；v. 增加；增多
plant|n. 植物；作物；车间；装置；工厂；发电厂；v. 种植；栽培；安置；放置
church|n. 教堂
evil|n. 邪恶；罪恶；adj. 恶毒的
reputation|n. 名声；名誉
claim|n. 声称；索要；要求；认领；v. 声称；要求；索赔
victim|n. 受害者
vicar|n. 教区牧师
source|n. 来源；出处；源泉；源头；提供资料者；v. 寻找货源
income|n. 收入；收益；所得
bark|v. 狗吠；咆哮；厉声说；n. 犬吠声；树皮
press|v. 按；压；n. 按；压；出版社；新闻界
paw|n. 爪子；脚爪
latch|n. 门闩；碰锁；弹簧锁；v. 用闩闩上；用碰锁锁上
expert|n. 专家；行家；adj. 老练的；内行的；专门的
develop|v. 发展；形成；制订
habit|n. 习惯
remove|v. 搬迁；去掉；移开；消除
future|n. 未来；将来；前途；adj. 将来的；未来的
fair|adj. 公平的；合理的；相当大的；n. 交易会；展销会；集市
fortune-teller|n. 算命者
crystal|n. 水晶；结晶；adj. 晶体的
relation|n. 关联；联系；亲属
impatiently|adv. 不耐烦地；急躁地
Hubble|n. 哈勃
telescope|n. 望远镜
launch|v. 发射；发起；启动；掷；n. 发射；投掷；启动
NASA|abbr. （美国）国家航空和航天局 ；“National Aeronautics and Space Administration”的缩写
billion|num. 十亿
faulty|adj. 有缺陷的；有故障的；有错误的
astronaut|n. 宇航员；太空人
shuttle|n. 梭子；穿梭；往返移动之物；航天飞机；v. 穿梭移动；往返运送
Endeavour|n. “奋进”号
robot-arm|n. 机器手臂
grab|v. 抓取；攫取
atmosphere|n. 大气；气氛；氛围
distant|adj. 遥远的；远处的；疏远的；冷漠的
galaxy|n. 星系；银河；银河系；一群出色的人（或物）
universe|n. 宇宙
eagle eye|phrase. 鹰眼；敏锐的目光
control|v. 控制；操纵；n. 控制；管制
smoke|v. 抽烟；冒烟；n. 烟；烟雾
desolate|adj. 荒凉的；孤寂凄凉的；v. 使荒无人烟；使孤寂凄凉
threaten|v. 威胁；恐吓
surrounding|adj. 周围的；附近的；v. 环绕；围绕；“surround”的现在分词
destruction|n. 毁灭；引起毁灭的根源
flood|n. 洪水；水灾；v. 淹没；泛滥
authority|n. 权威；权威人士；权力；当局；官方机构
grass-seed|n. 草籽
spray|n. 喷雾；v. 喷洒
quantity|n. 量；数量；大量
root|n. 根；根源；v. 生根
century|n. 世纪；百年
patch|n. 补丁；一小片；小块地；v. 打补丁；缝补
blacken|v. （使）变黑；中伤；诋毁
circle|n. 圆；圈；v. 圈出；环绕
admire|v. 钦佩；赞赏
close|v. 关闭；使接近；adj. 接近的；亲密的；adv. 接近地；紧挨地
wedding|n. 婚礼；婚宴
reception|n. 接待；招待会
sort|n. 种类；类别；v. 把…分类；拣选；理清；解决
tunnel|n. 隧道；地道；v. 开凿隧道
port|n. 港口
ventilate|v. 使通风；公开表达
chimney|n. 烟囱
sea level|phrase. 海平面
double|n. 两倍；v. （使）加倍；是…的两倍；把…对折
ventilation|n. 通风；通风装置
fear|v. 害怕；惧怕；n. 害怕；惧怕
invasion|n. 侵犯；侵略
officially|adv. 正式地；官方地
connect|v. 连接；接通
European|adj. 欧洲的；欧洲人的；欧盟的；n. 欧洲人
continent|n. 洲；大陆
versus|prep. 对…；与…相对
Christmas|n. 圣诞节
circus|n. 马戏团
present|n. 目前；礼物；adj. 在场的；目前的；v. 呈现；提出
accompany|v. 陪伴；伴随；为…伴奏
approach|v. 接近；靠近；临近；处理；n. 方法；接近；靠近；路径
ought|v. 应当；应该；可能会
weigh|v. 称量；权衡
fortunate|adj. 幸运的
Lancaster|n. 兰开斯特（美国一城市）
bomber|n. 轰炸机；投弹手
remote|adj. 偏远的；久远的；渺茫的；n. 遥控器
Pacific|n. 太平洋；adj. 太平洋的
wreck|v. 破坏；毁坏；n. 遇难船只；失事；残骸
rediscover|v. 重新发现
aerial|adj. 空气的；空中的；n. 天线
survey|v. 调查；勘测；n. 调查；勘测
rescue|n. 救援；营救；v. 救援；营救
package|n. 包；包裹；v. 包装
enthusiast|n. 热心者；热衷于…的人
restore|v. 恢复
imagine|v. 想象；设想；假想
packing case|phrase. （木制的）装货箱
colony|n. 殖民地；群体
bee|n. 蜜蜂
hive|n. 蜂箱；蜂巢；蜂群；闹市；v. 使（蜂）入蜂箱；群居
preserve|v. 保存；保护；保持；n. （某群体）专有的活动；保护区
beeswax|n. 蜂蜡；v. 涂蜜蜡于
volcano|n. 火山
active|adj. 积极的；活跃的；主动的
Kivu|n. 基伍湖
Congo|n. 刚果
Kituro|n. 基图罗（火山名）
erupt|v. 爆发；喷发
violently|adv. 激烈地；猛烈地
manage|v. 管理；设法做到；完成（困难的事）
brilliant|adj. 光辉的；明亮的；灿烂的；卓越的；极好的
liquid|n. 液体；adj. 液体的；液态的
escape|v. 逃避；逃走；n. 逃脱；逃避
alive|adj. 活着的；活泼的
persistent|adj. 执着的；坚持的；持续的
avoid|v. 避免；避开
insist|v. 坚持；坚决要求
murder|n. 谋杀；v. 谋杀；杀害
instruct|v. 教授；教导；指示；命令；通知
acquire|v. 获得；得到；学会
confidence|n. 信心；信任；秘密；私事
examiner|n. 考官；主考人；检查员
suppose|v. 认为；假设；猜想
tap|n. 水龙头；轻拍；轻敲；轻击；v. 轻拍；轻敲；利用；提取
react|v. 反应
brake|n. 刹车；制动器；v. 刹车
pedal|n. 踏板；踩踏板；v. 用脚踏动
mournful|adj. 悲哀的；哀痛的
bullfight|n. 斗牛
drunk|adj. 喝醉的；v. 喝；喝酒；“drink”的过去分词
wander|v. 徘徊；漫游
unaware|adj. 没意识到；不觉察的；不知道的
bull|n. 公牛；雄性大动物；胡扯；废话
matador|n. 斗牛士
apparently|adv. 据说；似乎；显然地
sensitive|adj. 敏感的；感情脆弱的；体贴的；善解人意的
criticism|n. 批评；指责；评论
charge|v. 使承担责任；收费；充电；指控；给…充电；n. 负责；收费；指控；谴责
clumsily|adv. 笨拙地；粗陋地
bow|n. 弓；蝴蝶结；鞠躬；v. （使）鞠躬
safety|n. 安全；平安
sympathetically|adv. 怜悯地；同情地
parliament|n. 国会；议会
erect|adj. 直立的；竖立的；v. 竖立；直立；建立
accurate|adj. 精确的；无误的
official|n. 官员；高级职员；adj. 官方的；正式的
Greenwich|n. 格林威治（英国城市）
observatory|n. 天文台；气象台
check|v. 检查；核实；克制；n. 检查；支票；方格图案
microphone|n. 麦克风；扩音器
tower|n. 塔；塔楼；v. 远远高于；高耸
racing|n. 赛车；竞赛；竞速；v. 比赛；疾走；“race”的现在分词
per|prep. 每；每一
Utah|n. 犹他州
horsepower|n. 马力
burst|v. 爆裂；突然而起；n. 爆裂；突然而起
average|adj. 平均的；普通的；n. 平均数；平均水平；v. 平均为…
footstep|n. 足迹；脚步声
record-holder|n. 纪录保持者
truant|n. 逃学者；旷课者；adj. 逃学的；怠惰的；v. 逃学；旷课
unimaginative|adj. 缺乏想象力的；无创意的
shame|n. 羞愧；羞耻；v. 使丢脸；使羞愧
hitchhike|v. 搭便车旅游；沿途搭乘别人车旅行
meantime|n. 期间；与此同时
lorry|n. 卡车；载重汽车
border|n. 边界；边疆；v. 和…毗邻；与…接壤
evade|v. 逃避；回避；躲避
limelight|n. 舞台灯光；公众注意的中心
precaution|n. 预防；预防措施
fan|n. 风扇；迷；v. 煽动；吹拂
shady|adj. 背阴的；阴凉的；可疑的
sheriff|n. 郡长；行政司法长官；警长；县治安官
sneer|v. 嘲笑；讥讽；n. 嘲笑；讥讽
thick|adj. 厚的；粗的；浓稠的
signal|n. 信号；标志；v. 用信号通知
stamp|n. 邮票；印记；跺脚；v. 盖印；跺脚
helicopter|n. 直升机
scene|n. 场景；现场；景色
survivor|n. 幸存者；生还者
fool|n. 傻瓜；蠢人；v. 愚弄
bulletin|n. 公告；布告；公报；新闻简报
announcer|n. 广播员；告知者；报幕员
macaroni|n. 通心粉
leading|adj. 最重要的；一流的；处于领导地位的；v. 带领；领导；“lead”的现在分词
grower|n. 种植者；生长物
splendid|adj. 壮观的；辉煌的；极好的
stalk|n. 茎；柄；梗；v. 跟踪；偷偷接近；昂首阔步地走
thresh|v. 打（谷）；脱粒
process|n. 过程；进程；工序；v. 处理；加工
Signor|n. 先生（意大利语）
champion|n. 冠军；优胜者；拥护者；v. 拥护；支持
studio|n. 演播室；录音棚；工作室
mummy|n. 木乃伊；干尸；妈咪
Egyptian|n. 埃及人；埃及语；adj. 埃及的；埃及人的
temple|n. 庙宇；太阳穴
mark|n. 记号；痕迹；分数；v. 做标记；（使）留痕迹；评分
plate|n. 盘子；碟子
disease|n. 病；疾病
last|adj. 最后的；最近的；adv. 最后；最近；v. 持续
prove|v. 证明；证实
resin|n. 树脂；合成树脂；v. 涂树脂
skin|n. 皮肤；毛皮；外皮；v. 剥皮；削皮
section|n. 部分；部门；章节
figure|n. 数字；身材；重要或有名的人物；v. 计算；认为；弄懂
normally|adv. 正常地；通常地
survive|v. 幸存；生存；存活
entitle|v. 授权；命名；给...权利（或资格）
calm|v. （使）平静；（使）镇定；adj. 平静的；镇静的；n. 平静
nerve|n. 神经；勇气；胆量
concentration|n. 专注；关注；聚集；浓度
suffer|v. 遭受；忍受
symptom|n. 征兆；症状
temper|n. 暴躁脾气；情绪；心情；性情；v. 使…缓和；冲淡
appetite|n. 胃口；食欲；嗜好；爱好
produce|v. 生产；生育；制造；出示；导致；引起；n. 农产品
urge|v. 催促；力劝；n. 强烈欲望；迫切要求
satisfaction|n. 满意；满足
delighted|adj. 高兴的；愉快的；快乐的；v. 使高兴；使愉快；“delight”的过去式和过去分词
parent|n. 父亲（或母亲）
flight attendant|phrase. 航空乘务员；空姐
frightened|adj. 惊吓的；受惊的；害怕的；v. 使惊吓；使惊恐；“frighten”的过去式和过去分词
curious|adj. 好奇的
bomb|n. 炸弹；v. 投弹于；轰炸
palace|n. 宫殿；王宫
extraordinary|adj. 不平常的；非凡的
exhibition|n. 展览；展出
iron|n. 铁；铁器；熨斗；镣铐；adj. 铁制的；坚强的；顽强的；v. 熨烫；用铁装备
various|adj. 各种各样的；不同的；各种的
machinery|n. 机械；机械（总称）
display|v. 展示；陈列；n. 展示；陈列
steam|n. 蒸汽；水蒸气；v. 蒸
profit|n. 利润；收益；v. 获利；有益于
college|n. 学院；大学
prisoner|n. 囚犯；犯人
bush|n. 灌木丛；矮树
rapidly|adv. 迅速地；快速地
uniform|adj. 一致的；统一的；n. 制服
rifle|n. 步枪；来复枪；v. 快速搜寻
shoulder|n. 肩膀；v. 承担
march|n. 行军；行进；游行；v. 行军；行进；游行
boldly|adv. 大胆地，显眼地
blaze|n. 烈火；火焰；闪耀；v. 闪耀；熊熊燃烧；发亮光
salute|n. 敬礼；致敬；行礼；v. 敬礼；致敬；行礼
elderly|adj. 年老的；年长的
grey|adj. 灰色的；暗淡的；n. 灰色；暗淡
sharp|adj. 锋利的；灵敏的；尖刻的；骤变的
blow|n. 吹；打击；v. 吹；打击
monster|n. 怪物；妖怪；庞然大物
sailor|n. 水手；海员
creature|n. 生物；动物
peculiar|adj. 奇怪的；独特的
shining|adj. 闪闪发亮的；华丽的；辉煌的；v. 照耀；发光；闪耀；“shine”的现在分词
oarfish|n. 桨鱼；皇带鱼
election|n. 选举；当选
former|adj. 以前的；前者的；n. 模子
defeat|v. 击败；战胜；使受挫；n. 失败；战胜
fanatical|adj. 狂热入迷的
opponent|n. 对手；反对者；敌手
radical|adj. 根本的；彻底的；激进的；n. 激进分子
progressive|adj. 先进的；前进的；n. 改革论者；进步论者
ex-|pref. （前缀）前…
suspicious|adj. 怀疑的；令人怀疑的
strike|v. 击打；罢工；侵袭；突然想到；划（火柴）；n. 罢工；袭击
busman|n. 公共汽车司机
state|n. 情形；状态；国家；州；v. 说明；陈述；声明；规定；adj. 国事礼仪（或规格）的；州的；邦的
agreement|n. 一致；同意；协议
relieve|v. 减轻；缓解
pressure|n. 压力；压强；压迫；v. 对…施加压力
extent|n. 长度；广度；程度
volunteer|n. 志愿者；v. 自愿做
gratitude|n. 感激之情；感谢
the Press|n. 新闻界
object|n. 物体；目的；对象；宾语；v. 反对；有意见；讨厌
inform|v. 通知；告知
headmaster|n. 校长
contribute|v. 捐献；投稿；贡献；促成
gift|n. 礼物；天赋
album|n. 相册；专辑
patience|n. 耐心；忍耐
encouragement|n. 鼓励；鼓舞
farewell|n. 再会；别了
honour|n. 荣誉；荣幸；尊敬；v. 尊敬；给予荣誉
coincidence|n. 巧合；一致
total|n. 总额；总计；v. 共计；总数达；adj. 总的；全部的
devote|v. 投入；献身
gardening|n. 园艺（学）；v. 从事园艺；“garden”的现在分词
hobby|n. 爱好
swing|n. 摇摆；秋千；v. 摇摆
speedboat|n. 快艇
desperately|adv. 绝望地；拼命地；不顾一切地；极度地
companion|n. 同伴；伴侣
water ski|phrase. （由快艇牵引水橇）滑水
buoy|n. 浮标；浮筒；救生圈；v. 使浮起；支撑；鼓励
tremendous|adj. 巨大的；极大的
petrol|n. 汽油
drift|v. 飘；漂流；漂移；n. 流动；趋势
gently|adv. 温柔地；温和地；轻轻地
alibi|n. 不在犯罪现场证明；辩解；托辞
commit|v. 犯（罪、错）；承诺；投入
inspector|n. 检查员；巡视员；视察员
employer|n. 雇主
confirm|v. 证实；确认；批准
truth|n. 真理；事实；真实
trap|n. 圈套；陷阱；困境；v. 设圈套；陷入（困境）
surface|n. 表面；v. 显露；给…铺路面
explosive|n. 炸药；爆炸物；adj. 爆炸的
vibration|n. 震动；颤动；抖动
collapse|v. 倒塌；昏倒；暴跌；折叠；n. 倒塌；崩溃；病倒；暴跌
drill|n. 钻机；反复的练习；v. 钻孔；（教某人）反复练习
capsule|n. 胶囊；太空舱；adj. 压缩的；概要的；v. 压缩；简述
layer|n. 层；层次
beneath|prep. 在…下面
lower|v. 降低；减少；adj. 较低的；下游的；adj. 更低的；“low”的比较级
progress|n. 进展；进步；缓慢前进；稳步前进；v. 进展；进步；（时间）逐渐过去；前进
smoothly|adv. 顺利地；平稳地；顺畅地
slip|v. 滑倒；滑落；溜走；悄悄地放；n. 滑倒；溜走；疏忽；纸片
comedy|n. 喜剧
queue|n. 行列；长队；v. 排队
dull|adj. 愚笨的；枯燥的；感觉迟钝的；无趣的；阴暗的
artiste|n. 表演艺术家；艺人
advertiser|n. 登广告者；广告商
chip|n. 炸薯条；芯片；碎片；v. 削成碎片；碎裂
overfish|v. 捕捞过度
giant|n. 巨人；伟人；adj. 巨大的；伟大的
terrify|v. 使恐惧；使惊吓
diver|n. 潜水员；跳水者
oil rig|phrase. 石油钻塔
wit|n. 机智（的人）；风趣（的人）；才智；头脑；智慧
cage|n. 笼子；vt. 把…关进笼子
shark|n. 鲨鱼
whale|n. 鲸；v. 捕鲸
variety|n. 变化；多样性；（同一事物）不同种类；（动植物的）品种
cod|n. 鳕鱼；鳕鱼肉
skate|v. 溜冰；n. 旱冰鞋
factor|n. 因素；要素；因数；代理人；倍数；系数；v. 把…因素包括进去；分解成因子；做代理商（或管家）
crew|n. 全体船员；全体人员
balloon|n. 气球；热气球；玩具气球；球状物；v. 乘热气球飞行；膨胀；（使）激增
royal|adj. 皇家的；盛大的
spy|n. 间谍；密探；v. 秘密侦察；发现
track|n. 轨道；踪迹；小路；跑道；v. 追踪；跟踪
binoculars|n. 双筒望远镜
fast|adj. 快的；迅速的；adv. 迅速；v. 禁食；斋戒
ladder|n. 梯子；阶梯
shed|n. 棚屋；v. 摆脱；去除；使脱落
sarcastic|adj. 讽刺的；嘲讽的；挖苦的
tone|n. 音调；色调；语气；氛围；强健状况；v. 使协调；使健壮
noble|adj. 贵族的；高尚的；n. 贵族
monument|n. 纪念碑；历史遗迹；不朽作品
statue|n. 雕像；雕塑
liberty|n. 自由
sculptor|n. 雕刻家；雕塑家
actual|adj. 真实的；实际的
copper|n. 铜；铜币
support|v. 支持；支撑；n. 拥护；帮助
framework|n. 骨架；支架；框架
transport|n. 运输；v. 运输
site|n. 位置；场所
pedestal|n. 底座；基座
Los Angeles|n. 洛杉矶（美国）
reluctant|adj. 不情愿的；勉强的
weight|n. 重量；砝码；秤锤；重物；负担；重要性；v. 使负担；装载过重；视…为重要
underwater|adj. 水下的；adv. 在水下
tricycle|n. 三轮脚踏车
compete|v. 竞争；比赛
yard|n. 码；院子；庭院
gasp|v. 喘气；喘息；倒抽气；n. 喘气；喘息
fantasy|n. 幻想；奇幻
ambassador|n. 大使
Escalopia|n. 艾斯卡罗比亚（虚构的国名）
frightful|adj. 可怕的；讨厌的；非常的
fire extinguisher|phrase. 灭火器
drily|adv. 冷淡地；枯燥无味地
embassy|n. 大使馆
heaven|n. 天堂；天国
basement|n. 地下室
definitely|adv. 明确地；肯定地
post|n. 邮件；邮寄；职位；帖子；岗位；柱；v. 邮寄；张贴；公布；使驻守
shot|n. 射击；射门；照片；注射；v. 射击；拍摄（电影）；疾驰；“shoot”的过去式和过去分词
festival|n. 节日
lantern|n. 灯笼；提灯
spectacle|n. 景象；奇观；场面；眼镜