puma|n. 美洲狮
spot|n. 斑点；圆点；地点；场所；v. 识别；发现；弄脏
evidence|n. 证据；证明
accumulate|v. 积累
oblige|v. 迫使；效劳
hunt|v. 打猎；搜寻
blackberry|n. 黑莓（浆果）
human being|phrase. 人类
corner|n. 角；（街道等的）拐角；困境；v. 拐弯；迫至一隅；使陷入绝境
trail|v. 跟踪；尾随；拖；落后于；n. 小径；路径；踪迹
print|v. 打印；印刷；n. 打印；印刷
cling|v. 紧贴；坚守
convince|v. 说服；使确信
somehow|adv. 不知何故；以某种方式
disturb|v. 打扰；妨碍
equal|adj. 相等的；同等的；v. 等于；比得上；n. 同等的人；相等物
vicar|n. 教区牧师
raise|v. 提起；增加；养育；筹募；引起；n. 加薪
torchlight|n. 手电筒光；火炬的光亮
goddess|n. 女神
archaeologist|n. 考古学家
Aegean|adj. 爱琴海的；n. 爱琴海
explore|v. 探索；勘探
promontory|n. 岬；海角
prosperous|adj. 繁荣的；兴旺的
civilization|n. 文明；文化
storey|n. 楼层
drainage|n. 排水；排水系统；放水
worship|n. 崇拜；崇敬；礼拜；v. 崇拜；尊崇；做礼拜
sacred|adj. 宗教的；神圣的；庄严的
fragment|n. 碎片；断片；片段；v. （使）成碎片；（使）分裂
remains|n. 遗迹；残余；遗体；v. 剩下；留下；依然不变；“remain”的第三人称单数
classical|adj. 古典的
reconstruct|v. 重建；重现
rest|v. （使）休息；（使）倚靠；停留在；中止；n. 休息；其他；剩余部分；宁静
hip|n. 臀部；髋部；adj. 赶时髦的
full-length|adj. 全身的；拖地的；标准长度的
graceful|adj. 优雅的；优美的；得体的
identity|n. 身份；特性；一致
manual|n. 说明书；指南；adj. 手工的；体力的
collar|n. 衣领；领子；v. 抓住；给....上领子
sacrifice|v. 牺牲；献出；供奉；n. 供奉；祭品；牺牲（品）
privilege|n. 特权；荣幸；v. 给予特权；特殊对待
dustman|n. 清洁工
corporation|n. 公司；企业
overalls|n. 工作服；n. （工作时穿的）罩衣；“overall”的复数
shower|n. 淋浴；阵雨；一阵
secret|n. 秘密；adj. 秘密的
status|n. 地位；身份；状态；职称；重要性
editor|n. 编辑（者）；剪辑员
extreme|adj. 极度的；非常的；末端的；n. 极端；极端的事物
statistics|n. 统计学；统计数字
journalist|n. 新闻记者
president|n. 总统；总裁；主持人；校长；行长
palace|n. 宫殿；王宫
publish|v. 发布；出版
fax|n. 传真；v. 发传真
impatient|adj. 不耐烦的；焦急的
fire|n. 火；炮火；热情；激情；v. 射击；开火；解雇；激发
originally|adv. 原来；起初
smash-and-grab|n. 砸橱窗抢劫
arcade|n. 拱廊；有拱廊的街道；游乐中心
Piccadilly|n. 皮卡迪利大街
jewellery|n. 珠宝；首饰
necklace|n. 项链
ring|n. 环；环形物；戒指；铃声；声调；拳击场；v. 成环形；环绕；响铃；鸣；给…打电话
background|n. 背景；经历
velvet|n. 天鹅绒；丝绒；adj. 天鹅绒的
headlight|n. （汽车等）前灯
blare|v. 发出（响亮而刺耳的声音）；n. 响亮刺耳的声音
staff|n. 职员；全体职工；棍棒；拐杖；v. 为…配备职员
raid|n. 袭击；突击；劫掠；v. 突袭；搜捕；劫掠
scramble|v. 攀登；爬；混杂；争抢；n. 攀登；爬；争夺；混乱
fantastic|adj. 奇异的；极好的；奇妙的
ashtray|n. 烟灰缸
mutilate|v. 使残废；使残缺不全；毁伤
chew|v. 咀嚼
fiancé|n. 未婚夫
microwave|n. 微波；微波炉；v. 用微波炉加热
oven|n. 烤箱；烤炉
safekeeping|n. 妥善保管
Newcastle|n. 纽卡斯尔
identify|v. 鉴定；识别；确认
spokeswoman|n. 女发言人
monastery|n. 修道院
St. Bernard|n. 圣伯纳德
pass|v. 路过；(时间)流逝；超过；传递；通过；n. (考试)及格；通行证
watchdog|n. 看门狗；监督者
rashly|adv. 轻率地；冒失地；仓促地
enclosure|n. 围场；围地；圈占地；随信附件
monk|n. 僧侣；修道士
privacy|n. 隐私；私密；隐私权
skier|n. 滑雪者
Easter|n. 复活节
fascinate|v. 强烈吸引住；使着迷
affectionate|adj. 挚爱的；有深厚感情的；充满深情的
mysterious|adj. 神秘的
submissive|adj. 顺从的；服从的；恭顺的
feline|adj. 猫（科）的；n. 猫科动物
independence|n. 独立；自主
high-rise|adj. 高层的（建筑）；n. 高楼；大厦；多层建筑物
windowsill|n. 窗沿；窗台
paratrooper|n. 伞兵；空降兵
squirrel|n. 松鼠；v. 贮藏
air-resistance|n. 空气阻力
impact|n. 冲击（力）；影响力；v. 冲击；撞击；对…产生影响
Southampton|n. 南安普敦
colossal|adj. 巨大的；庞大的
watertight|adj. 不透水的；无懈可击的
compartment|n. 分隔间；车厢
flood|n. 洪水；水灾；v. 淹没；泛滥
float|v. 浮动；漂浮
tragic|adj. 悲剧的；悲惨的；不幸的
liner|n. 邮轮；客轮；衬里
voyage|n. 航行；航海；v. 航行；远航
iceberg|n. 冰山
lookout|n. 前途；远景；看守；瞭望台
collision|n. 碰撞；冲突
narrowly|adv. 狭窄地；勉强地
miss|v. 想念；错过；漏掉；n. 错过；女士；小姐
slight|adj. 轻微的；微小的；细瘦的；n. 轻慢；v. 轻视
tremble|v. 发抖；打颤；战栗；焦虑；n. 震颤；发抖；战栗；焦虑
faint|adj. 微弱的；缺少热情的；虚弱的；v. 昏厥
horror|n. 恐惧
abandon|v. 抛弃；放弃；中止
plunge|v. 投入；跳入；n. 跳进；骤降
lifeboat|n. 救生艇
guilty|adj. 有罪的；内疚的
tolerant|adj. 宽容的；容忍的
declare|v. 宣布；宣告；断言；申报纳税
hardened|adj. 变硬的；硬心肠的；冷酷无情的；v. 使坚强；使坚硬；“harden”的过去式和过去分词
professional|adj. 专业的；职业的；n. 专业人士
smuggler|n. 走私者
officious|adj. 爱发号施令的；多管闲事的
confidently|adv. 满怀信心地
dreadful|adj. 可怕的；恐惧的；令人不快的
pounce|v. 猛扑；突袭；抓住；n. 猛扑
perfume|n. 香水；香味；v. 给…添加香味
sarcastically|adv. 讽刺地；挖苦地
exempt|adj. 被免除的；被豁免的；v. 豁免；免除
duty|n. 责任；职责；义务
gel|n. 凝胶体；定型发胶；v. 形成胶体；联手共事
mixture|n. 混合物；混合
unscrew|v. 拧开；旋开；旋松
nostril|n. 鼻孔
chalk|n. 粉笔
baggage|n. 行李
desert island|phrase. 荒岛
unrealistic|adj. 不切实际的；不实事求是的
paradise|n. 天堂
wretched|adj. 悲惨的；不幸的；难过的；恶劣的
starve|v. 挨饿；饿死
element|n. 元素；要素；成分
opportunity|n. 机会；时机
coral|n. 珊瑚；珊瑚虫；adj. 珊瑚色的；红色的
Virgin Islands|n. 维尔京群岛
Miami|n. 迈阿密
dinghy|n. 无篷小艇；小舟；救生筏
Caribbean|n. 加勒比海；adj. 加勒比海的
spear gun|phrase. 捕鱼枪
lobster|n. 龙虾
tanker|n. 油轮；加油飞机；罐车
genuinely|adv. 由衷地；真诚地；真正地
Robinson Crusoe|n. 鲁滨逊·克鲁索
costume|n. 服装；衣服；戏服；v. 给…穿上服装
consist|v. 由…组成；在于；一致；符合
sheet|n. 薄板；被单；纸张；（薄）片
effective|adj. 有效的；生效的
comfortable|adj. 舒服的；安逸的
storeroom|n. 贮藏室；库房
electricity|n. 电学；电力
metre|[又作meter]；n. 米；公尺；仪表
pace|n. 一步；步伐；步速；v. 踱步；调整步调
flee|v. 逃跑；逃离
slam|v. 砰地关上；猛动；抨击
gangster|n. 歹徒；匪徒；暴徒
Chicago|n. 芝加哥（美国）
protection|n. 保护
promptly|adv. 马上；迅速地；敏捷地；准时地
destroy|v. 破坏；摧毁
remarkable|adj. 值得注意的；显著的；非凡的；不寻常的
band|n. 乐队；带子；一伙
Florence|n. 佛罗伦萨（意大利都市名）
city-state|n. 城邦
hire|v. 雇用；租用
prince|n. 王子；君主
Florentine|adj. 佛罗伦萨式的
funeral|n. 葬礼
dedicate|v. 奉献；献身；致力
memory|n. 回忆；记忆力
valiant|adj. 勇敢的；英勇的
appreciate|v. 欣赏；理解；感激；增值
pocket money|phrase. 零用钱
rattle|n. 拨浪鼓；嘎嘎声；咔嗒声；v. 发出格格声；使紧张不安；喋喋不休
thrifty|adj. 节约的；节俭的
nephew|n. 侄子；外甥
bounce|v. 弹跳；反弹；n. 弹跳；跳动
pavement|n. 路面；人行道
stick|v. 粘附；刺；（随意）放置；卡住；忍受；n. 棍枝；球棍；条状物，（一）根
brigade|n. 旅；队；组；族
grease|n. 油脂；润滑油；动物油脂；贿赂；v. 给…加润滑油；涂油脂于；贿赂
prize|n. 奖赏；奖品；奖金；战利品；v. 珍视；珍藏；估价
tie|n. 领带；关系；约束；平局；淘汰赛；v. 绑；系；拴；约束；与...成平局
theft|n. 偷窃；盗窃罪
accuse|v. 指控；指责
deny|v. 否认；拒绝
ashamed|adj. 羞愧的；惭愧的
apologize|v. 道歉
dye|v. 给...染色 ；n. 染料
suspension|n. 悬浮；中止；暂缓
agreeable|adj. 愉悦的；宜人的；欣然同意的
situation|n. 情况；形势；情境
locate|v. 位于；查找…的地点；确定…的位置；使坐落于
immortal|adj. 不朽的；永世的；不死的；n. 不朽的人物；神仙；永生不灭者
Brooklyn|n. 布鲁克林区
Staten|n. 斯塔藤（岛），位于美国纽约
span|n. 间距；时距；跨度；v. 持续；跨越；涉及
cable|n. 电缆；钢索
concrete|adj. 具体的；有形的；混凝土的；n. 混凝土；具体物；v. 用混凝土覆盖
suspend|v. 吊；悬；暂停；延缓
length|n. 长度
estimate|v. 估算；估价；n. 估价；估算
capacity|n. 容量；容积；能力；身份；地位；资格
immensity|n. 广大；巨大；无限；浩瀚
elegant|adj. 优雅的；优美的；典雅的
faintly|adv. 微弱地；微细地；隐约地
current|n. （水、气、电）流；趋势；adj. 当前的；流通的
sculpture|n. 雕刻（术）；雕塑品；雕刻品；v. 雕塑；刻蚀
mistaken|adj. 搞错的；弄错的；误解的；v. 弄错；误解；“mistake”的过去分词
gallery|n. 画廊；美术馆
exhibit|v. 展览；陈列；展示；n. 展品；展览
oddly|adv. 古怪地；怪异地；反常地
attach|v. 系上；贴上；附加；使依附；使相关；隶属于
sphere|n. 球体；范围
magnetize|v. 使磁化；强烈吸引
repel|v. 排斥；相斥；击退；驱逐
flicker|v. 闪烁；摇曳；闪现；n. 闪烁；摇曳；闪现
emit|v. 发出；发射
flash|v. 闪光；闪现；n. 闪光；一刹那
prehistoric|adj. 史前的；陈旧的
electronic|adj. 电子的
peculiar|adj. 奇怪的；独特的
shock|n. 震惊；震动；冲击；电击；休克；浓密的头发；v. 使震惊；使震动；adj. 浓密的
emotionally|adv. 感情上；情绪上
dear|adj. 亲爱的；宝贵的；昂贵的；n. 亲爱的人；可爱的人
kidnapper|n. 绑匪；绑架者
considerable|adj. 重要的；相当大的；可观的
wealthy|adj. 富有的；富裕的
orderly|adj. 有秩序的；整齐的
disappearance|n. 消失；不见
anonymous|adj. 匿名的；无名的；不知名的
ransom|n. 赎金；v. 赎回
cardboard|n. 纸板；硬纸板；adj. 硬纸板做的；虚假的
withdraw|v. 撤回；撤退；提取
punctually|adv. 准时地
astound|v. 使震惊；使大惊
pioneer|n. 拓荒者；先驱者；创始者；倡导者；v. 开拓；做先锋；倡导
lord|n. 主；上帝；勋爵；统治者
Calais|n. 加来
overland|adj. 横跨陆地的；通过陆路的；adv. 由陆路
boxing|n. 拳击运动；v. 拳击；装箱
boxer|n. 拳击手；拳师犬
bare|adj. 赤裸的；空的；光秃秃的；仅有的；v. 使露出
prizefighter|n. 职业拳击手
crude|adj. 未加工的；粗鲁的；简陋的
marquis|n. 侯爵
technically|adv. 技术上；学术上；专业上；严格说来
science|n. 科学
popularity|n. 普及；流行
adore|v. 爱慕；敬慕；崇拜
alike|adj. 相同的；相像的；adv. 相同地；相像地
fame|n. 名声；声誉
eminent|adj. 著名的；非凡的；杰出的
bitterly|adv. 痛苦地；刺骨地；激烈地；极其地
bet|n. 打赌；赌注；v. 打赌；敢说
academy|n. 学院
extravagant|adj. 奢侈的；过度的
poverty|n. 贫困；短缺
run|v. 跑步；经营；n. 跑；运转
lines|n. （剧本中的）台词；n. 线；界线；绳；“line”的复数；v. 排队；画线；加衬里；“line”的第三人称单数
part|n. 部分；局部；零件；角色；v. 分离；分开
falter|v. （嗓音）颤抖；支吾；摇晃；踌躇；疲软；n. 支吾；踌躇；不稳；摇晃；疲软
cast|v. 投射；投掷；扔；n. 全体演员
role|n. 角色；职能；作用
aristocrat|n. 贵族
imprison|v. 监禁；束缚
Bastille|n. 巴士底狱
gaoler|n. 监狱看守；狱卒
colleague|n. 同事
curtain|n. 帷幕；窗帘
reveal|v. 揭露；泄露；（使）显露；n. （电视节目¸后的）揭示
cell|n. 细胞；小房间；牢房；单元格
blank|adj. 空白的；n. 空白处
squint|v. 眯着眼看；斜视；n. 斜视；一瞥
dim|adj. 暗淡的；昏暗的；模糊的；v. （使）变暗淡；（使）变模糊；（使）减弱
sire|n. 雄性种兽；（古语）陛下；v. 繁殖；成为父亲
proceed|v. 进行；继续；继续进行
poison|n. 毒药；毒物；v. 毒害；下毒
illogical|adj. 不合逻辑的；不合理的
octopus|n. 章鱼
delicacy|n. 精美；佳肴；微妙；棘手
repulsive|adj. 排斥的；令人厌恶的；使人反感的
stomach|n. 胃；腹部；v. 忍受；吃得下
turn|v. 转身；转弯；转动；转变；n. 轮到的机会；拐弯；转变
fry|v. 油炸；油煎
fat|adj. 肥的；n. 脂肪
abuse|v. 滥用；虐待；辱骂；n. 滥用；虐待；辱骂
snail|n. 蜗牛
luxury|n. 奢华；奢侈品；难得的享受
associate|v. 把…联系在一起；与…交往；n. 同事；伙伴；adj. 副的
despise|v. 鄙视；蔑视；看不起
appeal|n. 恳求；呼吁；上诉；吸引力；v. 呼吁；吸引；诉请
stroll|v. 闲逛；散步；漫步；n. 闲逛；散步；漫步
impulse|n. 冲动；脉冲；冲动力
dozen|n. 很多； 一打；十二个
fancy|n. 幻想；想象力；爱好；怪想；adj. 花哨的；昂贵的；新奇的；v. 想象；设想；想要；喜爱
skeleton|n. 骨架；骷髅；纲要；梗概；adj. 骨干的；骨骼的
seemingly|adv. 似乎；看似；表面上看
respectable|adj. 可敬的；值得尊敬的；体面的；可观的
conceal|v. 隐藏；隐瞒
vivid|adj. 生动的；鲜艳的；栩栩如生的
dramatic|adj. 急剧的；激动人心的；戏剧（性）的
ruin|n. 毁灭；废墟；v. 毁灭；破坏
heroine|n. 女英雄；女主角
fiction|n. 小说；虚构
varying|adj. 不同的；v. 改变；变化；“vary”的现在分词
medicine|n. 药；医学
guestroom|n. （私人住宅的）客房
unpack|v. 从（箱等中）取出
stack|n. 一摞；一叠；一堆；大烟囱；v. 把…放成整齐的一摞
underclothes|n. 内衣裤；贴身衣
drawer|n. 抽屉；起草者；开票人
petrify|v. 使石化；使僵化；吓呆
dangle|v. 悬垂；吊摆
sway|v. 摇摆；摇动；影响；n. 摇摆；影响；支配
unsympathetic|adj. 无同情心的；冷漠的；不讨人喜欢的；不赞成的
medical|adj. 医疗的；医术的
impressive|adj. 令人印象深刻的；令人钦佩的
steamship|n. 轮船；汽船
vessel|n. 器皿；容器；船；血管
era|n. 时代；纪元
Java|n. 爪哇
rudder|n. （船）舵；（飞机的）方向舵
roll|v. 滚动；翻转；n. 卷；滚动；卷形物
steer|v. 驾驶；引导；掌舵；操纵；n. 犍牛
temporary|adj. 短暂的；临时的
plank|n. 厚板；板条；（政党的）政纲条目；v. 在…上铺板
fit|adj. 健康的；适合的；v. 符合；合身
Equator|n. 赤道
delay|v. 推迟；延缓；耽搁；n. 推迟；延缓；耽搁
influence|n. 影响（力）；有影响的人或物；v. 影响
pride|n. 骄傲；自豪；自尊；v. 对…感到自豪
taste|n. 味觉；味道；品味；喜好；v. 品尝；有…味道
exert|v. 运用；施加
subtle|adj. 微妙的；细微的；隐晦的
advertiser|n. 登广告者；广告商
classify|v. 分类；归类
magic|n. 魔术；魔法；adj. 魔术（似）的；神奇的
sample|n. 样品；样本；v. 尝试，体验；抽样；节录
devise|v. 想出；设计；发明
capture|v. 逮捕；夺取；吸引；记录；准确地描述；n. 抓捕；攻占
manufacturer|n. 制造商
wheelbarrow|n. 手推车；独轮车
boot|n. 靴子；长筒靴
ingredient|n. 成分；配料；要素；因素
crane|n. 起重机；鹤
anticipate|v. 预料；预期；期望；抢先；提前使用
philosopher|n. 哲学家
wisdom|n. 智慧；明智；学问
priest|n. 牧师；神父；教士
spiritual|adj. 精神上的；心灵的
grudge|n. 怨恨；积怨；嫌隙；v. 勉强做；不情愿地给；吝惜
surgeon|n. 外科医生
passer-by|n. 过路人；行人
dignity|n. 尊严；高贵；尊贵；庄严
deliberately|adv. 有意地；蓄意地；谨慎地
consequence|n. 后果；结果
afflict|v. 使痛苦；使苦恼；折磨
ease|v. 缓解；减轻；n. 安逸；轻松
nature|n. 自然；本性
contempt|n. 蔑视；轻蔑
envious|adj. 羡慕的；忌妒的
wares|n. 商品；货物
anchor|n. 锚；靠山；台柱子；v. 抛锚；使稳固；主持节目
deck|n. 甲板；舱面
silverware|n. 银器
tempt|v. 诱惑；引诱；怂恿；劝诱
bargain|n. 交易；便宜货；协议；v. 讨价还价
disembark|v. 上岸；下船；登陆
assail|v. 攻击；困扰；抨击；袭击
marble|n. 大理石；弹珠；理智；adj. 大理石的
inscribe|v. 题写；铭刻；题名
favour|n. 喜爱；赞同；v. 赞成；有利于；偏爱
gesticulate|v. （讲话时）以手势示意
outrageous|adj. 粗暴的；极无礼的；十分讨厌的；骇人的
thrust|v. 刺；戳；n. 推力；刺；戳
largely|adv. 大部分地；主要地；大量地
comic|adj. 喜剧的；滑稽的；n. 连环漫画；喜剧演员
universal|adj. 普遍的；全体的
comedian|n. 喜剧演员；滑稽人物
distasteful|adj. 使厌恶的；使憎恶的；使不悦的
pester|v. 不断打扰；纠缠；烦扰
dread|v. 害怕；畏惧；n. 恐惧；畏惧
recovery|n. 恢复；复苏
plaster|n. 灰泥；膏药；熟石膏；v. 涂以灰泥；敷以膏药
console|v. 安慰；慰问；n. 控制台；操纵台
hobble|v. 跛行；蹒跚；捆绑（马等的）两腿
compensate|v. 补偿；弥补
mumble|v. 咕哝；含糊地说；n. 含糊的话；咕哝
labourer|n. 劳动者；劳工；工人
overnight|adv. 在夜里；突然；adj. 整晚的；突然的
hay|n. 干草
corn|n. 玉米；谷物
moonlight|n. 月光；v. 兼职；（尤在夜间）从事第二职业
conscientious|adj. 本着良心的；勤勉认真的；尽责的
suspect|v. 猜想；怀疑；n. 嫌疑犯；adj. 令人怀疑的；不可信的
desert|n. 沙漠；荒漠；v. 抛弃
regiment|n. （军队的）团；大群；大量；v. 把...编组；严格管制
action|n. 行动；行为
recluse|n. 隐居者；遁世者；隐士
lovable|adj. 可爱的；惹人爱的
eccentric|adj. 古怪的；偏离轨道的；n. 怪人；偏离轨道运行
disregard|v. 漠视；不理会；不顾；n. 漠视；忽视
convention|n. 习俗；大会；协定
conscious|adj. 有意识的；有知觉的；刻意的
invariably|adv. 不变地；总是
routine|n. 常规；例行公事；adj. 常规的；例行公事的
shrewd|adj. 精明的；敏锐的；机灵的
eccentricity|n. 怪癖；古怪；离心率
legendary|adj. 传奇的；传说的；享有盛名的
snob|n. 势利小人；谄上欺下的人；恃才傲物的人
intensely|adv. 强烈地；极度；剧烈地
bedraggled|adj. 湿漉漉的；乱蓬蓬的；全身泥污的；脏兮兮的；v. 弄脏；弄湿；弄皱；“bedraggle”的过去式和过去分词
dump|v. 倒空；n. 垃圾场
apologetic|adj. 道歉的；谢罪的；愧疚的
reprimand|n. 申斥；谴责；v. 斥责；训斥
stage|n. 阶段；时期；舞台；v. 举行；上演
elaborate|v. 精心制作；详尽阐述；adj. 精心制作的；详尽的
salvage|v. 打捞；挽救；挽回；抢救；n. （对财物等的）抢救；抢救出的财物
Barents|n. 巴伦支海
sunken|adj. 沉没的；凹陷的
cargo|n. 货物
bullion|n. 金（银）块；金（银）条
scour|v. 擦净；擦亮；四处搜索；n. 擦；冲刷
chest|n. 胸部；胸膛；箱子；柜子
contents|n. 内容；含量；“content”的复数
belongings|n. 所有物；财产
item|n. 项目；条款；一则； 一件物品或商品
cruiser|n. 巡洋舰；游艇
find|v. 找；找到；发现；认为
log book|phrase. 日志簿；日记簿；航海日记
piece|n. 片；块；件；作品；v. 拼凑
convoy|n. 护送；护航；护卫；v. 护航；护送
torpedo|n. 鱼雷；v. 用鱼雷袭击；完全摧毁
submarine|n. 潜水艇；adj. 海面下的
naval|adj. 海军的
ministry|n. （政府的）部；（全体）牧师
prelude|n. 前奏；序曲；序幕
unforeseen|adj. 意料之外的；未预见到的
series|n. 连续；系列
catastrophe|n. 灾难
crockery|n. 陶器；瓦器
suburb|n. 市郊；郊区
collide|v. 碰撞；相撞；冲突
learner|n. 学习者；初学者
panic|n. 恐慌；惊恐；v. 使…惊慌；感到恐慌
windscreen|n. 挡风玻璃
alongside|prep. 在…旁边；与…一起；adv. 在…的侧面；与…并排
slide|v. （使）滑动；下滑；n. 幻灯片；滑梯
stray|v. 迷路；偏离；走失；n. 离群者；走散者；adj. 走失的；离群的
confusion|n. 困惑，混乱；混淆
greedily|adv. 贪婪地；狼吞虎咽地
devour|v. 吞食；吞噬；狼吞虎咽地吃；如饥似渴地看
antique|n. 古董；古代文物；adj. 古老的；过时的
fascination|n. 迷惑力；魅力
forbidding|adj. 冷峻的；令人生畏的；可怕的；v. 禁止；不准；“forbid”的现在分词
muster|v. 鼓起；集合；召集；n. 集合；集合的人群
pretentious|adj. 自命不凡的；自负的；矫饰的
labyrinth|n. 迷宫；难解的事件；错综复杂
musty|adj. 有霉味的；发霉的
rarity|n. 罕见；稀有；珍品
assorted|adj. 混杂的；什锦的；各样的
junk|n. 废旧杂物；无价值的东西
carve|v. 雕刻；切开
dagger|n. 匕首；短剑
litter|n. 垃圾；杂物；一窝小崽；担架；v. 乱扔；乱丢杂物
dedicated|adj. 专注的；献身的；专用的；v. 奉献；献身；致力；“dedicate”的过去式和过去分词
bargain hunter|phrase. 到处寻找便宜货的人
dealer|n. 经销商；商人
cherish|v. 珍爱；爱惜；怀念；怀有（感情）；抱有（希望）
amply|adv. 充足地；详细地
masterpiece|n. 杰作；名著
mere|adj. 仅仅的；只不过的
prise|v. 撬开
miniature|adj. 微型的；小型的；v. 使成小型；n. 微型
composition|n. 构成；作品，作曲；（学生）作文；创作技巧
justice|n. 公正；公平；法官
court|n. 法院；球场；宫廷；v. 求爱；献殷勤；招致
law|n. 法律；定律
innocence|n. 无罪；清白；纯真
undertake|v. 承担；从事；保证
arduous|adj. 艰巨的；费力的
abstract|adj. 抽象的；非具体的；深奥的；v. 提取；抽取；作…的摘要；n. 摘要；概要；抽象派艺术作品
concept|n. 观念，概念
mete out|phrase. 给予；处置
interference|n. 干扰；干涉；妨碍
accord|v. 符合；一致；给予；n. 协议；条约；协调
premises|n. （企业或机构使用的）房屋及土地；n. 前提；假定；“premise”的复数
convert|v. 转换；转变；变换；使...改变信仰；n. 皈依者
disused|adj. 不再使用的；废弃的；n. 不用；废弃；“disuse”的过去式和过去分词
fireplace|n. 壁炉
muffle|v. 使声音降低；压抑（声音）；蒙住；裹
chip|n. 炸薯条；芯片；碎片；v. 削成碎片；碎裂
blacken|v. （使）变黑；中伤；诋毁
emerge|v. 浮现；显露；暴露
credulous|adj. 轻信的
improbable|adj. 不大可能的
obscure|adj. 昏暗的；不清楚的；无名的；v. 使模糊；使隐晦；使费解
maidservant|n. 女仆；侍女
presume|v. 假设；假定；设想；冒昧
wickedly|adv. 坏心眼地；居心叵测地
plot|n. 小块用地；图表；情节；阴谋；秘密计划；v. 划分；设计情节；绘图；密谋
downfall|n. 没落；垮台；骤雨
naive|adj. 幼稚的；天真的；不成熟的
unacceptable|adj. 不能接受的
conspire|v. 阴谋策划；协力促成
incredible|adj. 难以置信的
resemblance|n. 相似；相像
scorn|n. 蔑视；v. 蔑视
acquaint|v. 使熟悉；使相识
reunite|v. 再结合；再统一；重聚
assume|v. 假定；设想；呈现；承担
express|v. 表达；表示；n. 特快列车；快件服务；adj. 明确的
punctual|adj. 准时的
condition|n. 状态；条件；环境；v. 使适应；影响；保养
unshakable|adj. 不可动摇的；坚定不移的
faith|n. 信心；信仰；信任；真诚；忠实
cancel|v. 取消
exceptionally|adv. 例外地；异常地；特殊地
dislocate|v. 使关节脱位；使脱臼；使混乱
blame|v. 责怪；归咎于；指责；n. 责备；责任；指责
consult|v. 咨询；查询；请教
direct|adj. 直接的；v. 指导；指示
odd|adj. 奇怪的；奇数的；不成对的；不经常的；adv. （用于数字后）大约
reflect|v. 反射；反映；反省；思考；仔细考虑
advantage|n. 优势；好处；有利条件
mighty|adj. 强大的；有力的；巨大的；adv. 非常；很；极其
dawdle|v. 磨蹭；拖延；游荡
chug|n. （火车等缓行时的）轧轧响声；v. 发出轧轧声
lodge|n. 小舍；传达室；v. 存放；借宿；提出（抗议）
complaint|n. 投诉；抱怨
triumph|v. 战胜；成功；n. 胜利；凯旋
asterisk|n. 星号；v. 给…注上星号
conduct|v. 实施；表现；指挥；引导；传导（电、热）；n. 行为，举止；实施方式
calendar|n. 日历
historian|n. 历史学家
unique|adj. 唯一的；独特的
steadily|adv. 稳定地；稳固地
solely|adv. 只；仅；唯；单独地
video|n. 视频；录像；adj. 视频的；录像的
CD-ROM|abbr. 光盘只读存储器；光盘驱动器；“compact disc read-only memory”的缩写
bewilder|v. 使迷惑；使...不知所措
deduce|v. 推断；演绎；推论
scanty|adj. 欠缺的；过小的；少量的
mammoth|adj. 巨大的；庞大的；n. 猛玛（象）；庞然大物
tusk|n. 长牙；獠牙；尖牙；v. 用长牙齿戳
nomad|n. 游牧民；流浪者；游牧生活；流浪生活
correlate|v. （使）相互关联
clue|n. 线索；提示
insignificant|adj. 无关紧要的；不重要的
shed|n. 棚屋；v. 摆脱；去除；使脱落
advent|n. 到来；出现
agriculture|n. 农业
assumption|n. 假设；假想
dot|n. 小圆点；点；v. 在...上加点
symbol|n. 符号；象征；标志
engrave|v. 在…上雕刻；铭记
ivory|n. 象牙；乳白色
phase|n. 阶段；时期；相位；v. 分阶段进行
primitive|adj. 原始的；简陋的
depict|v. 描述；描绘
rough|adj. 粗糙的；粗暴的；粗略的；艰苦的；adv. 粗野地；艰苦地
boulder|n. 巨石；大圆石
pit|n. 坑；凹洞；矿井；v. 使凹陷
perturb|v. 使焦虑；使不安；扰乱
underestimate|v. 低估；对…估计不足；n. 低估；轻视
swerve|v. 突然转向；改变方向；n. 转向
scoop|n. 勺子；球型勺；长柄勺；独家新闻；v. 用勺舀；挖空；抢先获得
hammer|n. 锤子；v. 锤打
ominously|adv. 恶兆地；不吉利地；预示地
rip|v. 撕裂；扯开 ；n. 裂口；裂缝
zigzag|adj. 之字形的；曲折的；锯齿形的；n. 之字形； 锯齿形；adv. 作Z字形地；曲折地；v. 成Z字形；曲折前进
shallow|adj. 浅的；浅薄的
grind|v. 碾碎；磨碎；n. 苦差事
petrol|n. 汽油
stretch|v. 伸展；延伸；持续；n. 伸展；弹性；一段
obstacle|n. 障碍
clump|n. 丛；笨重的脚步声；土块；v. 使成一丛；凝结成块；拖着沉重的步子走
fissure|n. 裂缝；裂隙
renew|v. 重新开始；更新
pleading|n. 恳求；答辩状；诉状；adj. 恳求的；v. 恳求；辩护；答辩；以…为理由；“plead”的现在分词
gear|n. 用具；齿轮；排挡；v. 换挡；调整；（使）适合
astride|adv. 叉开两腿；跨着；骑着；prep. 跨着；骑着
crack|n. 裂缝；裂纹；噼啪声；v. 断裂；破裂；打击；使崩溃
halt|n. 停顿下来；v. 暂停；中断
dashboard|n. 仪表板；仪表盘
hoax|n. 骗局；恶作剧；戏弄；v. 愚弄
deception|n. 欺骗；骗局
self-respecting|adj. 自尊的；自重的
indulge|v. 放任；沉溺；使满足；听任
pneumatic|adj. 气动的；风动的；充气的；n. 气胎
drill|n. 钻机；反复的练习；v. 钻孔；（教某人）反复练习
silly|adj. 愚蠢的；可笑的
advance|n. 发展；进步；提前；v. 前进；发展；提前；adj. 预先的；在前的
archway|n. 拱道；拱门
remonstrate|v. 抗议；表示异议；劝诫
ironically|adv. 讽刺地；说反话地
permission|n. 许可；批准
grant|v. 允许；承认；授予；n. 授予物；补助金
illusion|n. 错觉；幻觉
pastoral|adj. 牧师的；牧人的；田园的；n. 牧歌；田园诗；田园景色
breed|v. 饲养；交配繁殖；n. 品种
rapture|n. 狂喜；非常高兴；v. 使…狂喜
extol|v. 颂扬；赞扬
superior|adj. 更好的；有优越感的；上级的；n. 上级；上司
cockcrow|n. 鸡鸣；拂晓之时
twitter|v. 吱吱喳喳；嘁嘁喳喳地讲；n. 叽叽喳喳的叫声
glint|v. 闪亮；闪光；n. 闪亮；闪光
pasture|n. 牧场；放牧；牧草；v. 放牧；吃草
idyllic|adj. 田园诗的
virtually|adv. 几乎；实际上；事实上；差不多
dubious|adj. 可疑的；怀疑的；拿不准的
misery|n. 痛苦；悲惨
acquaintance|n. 认识的人；相识
treat|v. 对待；招待；治疗；n. 款待
dweller|n. 居民；居住者
stagger|v. 蹒跚；犹豫；动摇；n. 蹒跚；踌躇；摇摆不定
exotic|adj. 外来的；外国来的；奇异的
glow|v. 发光；发热；脸红；n. 红光；炽热；脸红；喜悦
descend|v. 下降；突然造访；突袭；沦落；起源
tuck|v. 把…塞进狭窄的空间；把…藏入；n. 褶皱；零食
obstinately|adv. 顽固地；固执地
caveman|n. （史前石器时代的）穴居人；野人
pot-holing|n. 洞穴探险；洞穴探险运动
solitude|n. 孤独；独处；寂寞
lure|v. 吸引；诱惑；引诱；n. 诱惑；诱饵；吸引力
pot-holer|n. 洞穴探险者
rambler|n. 漫步者；散步者
undertaking|n. 事业；企业；承诺；保证；v. 承担；从事；保证；“undertake”的现在分词
foresight|n. 先见；预见；先见之明
foretell|v. 预言；预示；预卜
Grenoble|n. 格勒诺布尔（法国东南部城市）
chasm|n. 裂口；深坑；显著差别
flaw|n. 瑕疵；缺陷；裂痕；v. 使有裂纹；使有缺陷
distinguished|adj. 卓越的；出众的；著名的；v. 区分；辨别；“distinguish”的过去式和过去分词
Everest|n. 埃佛勒斯峰（即珠穆朗玛峰）
wade|v. 趟水；涉水；艰苦地进行
waterfall|n. 瀑布
inflatable|adj. 可充气的；可膨胀的；n. 可充气物品
rubble|n. 碎石；瓦砾
insistent|adj. 坚持的；迫切要求的；持续的
boom|n. 繁荣；景气；v. 发出隆隆声；快速发展；暴涨
waterspout|n. 强大的水柱；水龙卷
cleft|n. 裂缝；裂口；adj. 劈开的；v. 劈开；砍开；坚守；信守；忠于；“cleave”的过去式和过去分词
cavern|n. 大洞穴；大山洞
stalagmite|n. 石笋
stalactite|n. 钟乳石
limestone|n. 石灰岩；石灰石
glisten|v. 闪光；闪耀；n. 闪光；闪耀
eerie|adj. 可怕的；怪异的；怪诞的
dome|n. 穹顶；圆屋顶
insure|v. 保险；确保
fete|n. 游园会；庆祝；盛大节日；v. 宴请；招待
premium|n. 保险费；奖金；额外费用；溢价；adj. 高价的；优质的
recover|v. 恢复；重新获得；复原
admittedly|adv. 公认地；普遍承认地；诚然
purchase|n. 购买；采购；v. 购买；采购
annual|adj. 每年的；一年一次的；n. 年刊；年鉴
teenager|n. （十三到十九岁的）青少年
capsize|v. （船等）倾覆
shiver|v. 哆嗦；颤抖；n. 哆嗦；颤抖
dive|v. 潜水；跳水；暴跌；n. 潜水；跳水；暴跌
haul|v. 拖；拉；拖运；n. 拖；拉；拖运
hawser|n. 粗绳；钢索；锚链
rim|n. 边；缘
winch|n. 绞车；起货机；v. 用绞车吊起
agonizing|adj. 造成极度痛苦的；令人焦虑不安的；v. 感到极度焦虑；折磨；苦苦思索；“agonize”的现在分词
perch|n. 栖息处；栖枝；高处；鲈鱼；v. 栖息；处于（高处）
precariously|adv. 危险地；不稳固地；不稳定地
overbalance|v. （使）失去平衡；重于
clamp|v. 紧夹住；n. 夹具；夹钳
vertically|adv. 垂直地；直立地；竖直地
torrent|n. 急流；激流；湍流；一连串
rebound|v. 弹回；反作用于；n. 篮板球；弹回
positively|adv. 明确地；断然地；肯定地
cramped|adj. 狭窄的；难认的；v. 束缚；使痉挛；用夹钳夹紧；“cramp”的过去式和过去分词
stuffy|adj. 闷热的；不透气的；不通风的
monotonous|adj. 单调乏味的；毫无变化的
rhythm|n. 节奏；韵律
click|v. 发出咔哒声；点击；n. 咔哒声；点击
lull|v. 使镇静；使安静；哄骗；麻痹；n. 间歇期；平静期
snatch|v. 攫取；夺取；抓住；n. 攫取；夺取；抓住
sleeper|n. 睡眠者；枕木；卧铺
fumble|v. 乱摸；摸索；笨手笨脚地做；n. 摸索；笨手笨脚
inspection|n. 检查；视察；查看；审视
inevitably|adv. 不可避免地；必然地
destination|n. 目的地；终点
exhaust|v. 耗尽；用完；使筋疲力尽；n. 排气管；废气
motorway|n. 高速公路
ferry|n. 渡船；渡口；v. 摆渡；运送
cruise|v. 乘船游览；航游；缓慢行进；n. 乘船游览；航游
civilize|v. 使开化；使文明；教化
spacious|adj. 宽敞的；广阔的
seasick|adj. 晕船的
intimidate|v. 胁迫；威胁；恐吓
disadvantage|n. 不利；劣势；短处；v. 使处于不利地位
exhilarating|adj. 使人高兴的；令人兴奋的；振奋的；v. 使高兴；使振奋；“exhilarate”的现在分词
escapist|n. 逃避现实的人；adj. 逃避现实的
sip|v. 呷；啜；小口喝；n. 一小口
champagne|n. 香槟酒
refinement|n. 精炼；改进；文雅
breathtaking|adj. 惊人的；激动人心的；惊险的
soar|v. 翱翔；骤升
effortlessly|adv. 毫不费力地；轻易地
landscape|n. 景色；风景画
fresh|adj. 新鲜的；新的；刚发生的；无经验的
uncrumpled|adj. 没有垮下来的
democratic|adj. 民主的
restrict|v. 限制；约束
contention|n. 争论；论点；争辩
untold|adj. 没有说出的；数不清的
South Dakota|n. 南达科他州（美国）
perpetual|adj. 永恒的；持续的；永久的
quintuplet|adj. 五胞胎之一
obscurity|n. 昏暗；晦涩；不出名
radically|adv. 彻底地；根本地
exclusive|adj. 独有的；高级的；排外的
nursery|n. 托儿所；苗圃
commercialization|n. 商业化；商品化
commodity|n. 商品；货物；日用品
plead|v. 恳求；辩护；答辩；以…为理由
ignorance|n. 无知；愚昧
publication|n. 发表；公布；出版；出版物
newlyweds|n. 新婚夫妇
gaily|adv. 愉快地；艳丽地
leisure|n. 空闲；闲暇
keen|adj. 热心的；敏锐的；渴望的
advisory|adj. 劝告的；顾问的；咨询的；n. 公告；警告
novice|n. 新手；初学者；新信徒
consumer|n. 消费者
assemble|v. 装配；集合
outlet|n. 出口；发泄途径；经销店；折扣店
creative|adj. 有创造力的
handyman|n. 手巧的人；杂工；能工巧匠
resourceful|adj. 资源丰富的；机敏的；足智多谋的
fuse|n. 保险丝；导火线；引信；v. 由于保险丝烧断而电路不通；熔接；结合
rickety|adj. 不结实的；不稳固的；摇晃的
clog|n. 厚木底皮鞋；木屐；v. 堵塞；妨碍
delusion|n. 错觉；妄想
lawn mower|phrase. 割草机
adjustment|n. 调整；调节；适应
screw|n. 螺丝钉；v. 拧紧
dismantle|v. 拆除；拆卸
chunk|n. 厚块；大片
snap|v. 突然断裂；劈啪作响；猛然咬；快速地说；拍照；n. 啪嗒声；快照；adj. 突然的；匆忙的；adv. 劈啪作响地
insurmountable|adj. 无法克服的；难以解决的；不可逾越的
jigsaw|n. 拼图游戏；竖锯
nag|v. 唠叨；喋喋不休；不断困扰；n. 老马；驽马；矮小马
rust|n. 铁锈；v. 生锈
pollution|n. 污染；污染物
overpopulated|adj. 人口过多的
over-industrialized|phrase. 过度工业化的
sheer|adj. 十足的；纯粹的；陡峭的
worldwide|adj. 全球性的；adv. 全球性地
overwhelm|v. 使不知所措；使无法解决；击败；压垮；淹没
pollute|v. 污染
pesticide|n. 杀虫剂；除害药物
fertilizer|n. 肥料
salmonella|n. 沙门氏菌
listeria|n. 利斯特杆菌
vegetarian|n. 素食者；食草动物；adj. 素食者的；素菜的
organically-grown|adj. 有机培植的
insidious|adj. 阴险的；潜伏的；暗中为害的
urban|adj. 城市的；都市的
burglar|n. 窃贼；夜盗
burgle|v. 破门盗窃；入室偷窃
scream|n. 尖锐刺耳的声音；v. 尖叫；呐喊
profound|adj. 深刻的；渊博的；深奥的；深远的
irritation|n. 愤怒；激怒；疼痛处
incessantly|adv. 不停地；不间断地
whine|v. 哭诉；发牢骚；发呜呜声；n. 呜咽声；抱怨；牢骚
helicopter|n. 直升机
maximum|n. ¸大限度；¸大量；adj. ¸多的；¸大极限的
technology|n. 科技；技术
contribution|n. 贡献；捐助物；投稿；稿件
mobile|adj. 可移动的；易变的
snore|v. 打鼾；打呼噜；n. 打呼噜（声）；打鼾（声）
offender|n. 得罪人的人；犯罪者；违法者
staggering|adj. 令人惊愕的；难以置信的；v. 蹒跚；犹豫；动摇；“stagger”的现在分词
trumpet|n. 喇叭；小号；v. 宣扬；吹嘘
partner|n. 合伙人；搭档
inaccessible|adj. 难以达到的；无法接近的
hospitable|adj. 好客的；热情友好的；殷勤的；（气候、环境等）适宜的
hostile|adj. 敌意的；敌对的
vicinity|n. 附近；周围地区；邻近地区
architectural|adj. 建筑学的；建筑方面的
fresco|n. 壁画；v. 作壁画
abruptly|adv. 突然地；唐突地
tramp|n. 流浪汉；流浪乞丐；徒步旅行；v. 步行；踩；踏
moor|n. 旷野地；荒野；高沼；v. （使）停泊；系泊
straggle|v. 蔓延；散乱地分布；落伍
dilapidated|adj. 残破的；倒塌的
sardine|n. 沙丁鱼；沙丁鱼罐头
rag|n. 旧布，破布
motionless|adj. 不动的；静止的
procession|n. 行列；队伍
shawl|n. 披肩；围巾
peer|v. 凝视；盯着看；与...同等；n. 同等的人；同辈；贵族
quicken|v. 加速；使更活跃；刺激
rambling|adj. 杂乱无章的；不规则的；v. 漫步；漫谈；蔓延；“ramble”的现在分词
sentimentally|adv. 感情上；多情地
lavishly|adv. 浪费地；丰富地；大方地
immaculate|adj. 清洁的；无瑕疵的；无过失的
parquet|n. 拼花地板；镶木地板
gleam|v. 闪烁；隐约闪现；n. 亮光；闪光
preside|v. 主持；指挥；担任会议主席
invisible|adj. 看不见的；无形的
scrub|n. 擦洗；刷洗；灌木丛；v. 擦洗；刷洗
enlightened|adj. 开明的；有见识的；启迪的；v. 启发；开导；“enlighten”的过去式和过去分词
fickleness|n. 变化无常；浮躁
unrelenting|adj. 不屈不挠的；不松懈的；无情的
disillusion|v. 使不再抱幻想；使理想破灭；n. 幻灭；理想破灭
industriousness|n. 勤奋
qualification|n. 资格；条件
mirth|n. 欢乐；欢笑
cellar|n. 地窖；地下室
resolution|n. 决心；坚决；决议；解决；分辨率
mentally|adv. 精神上；思想上；智力上
compile|v. 汇编；编制
formidable|adj. 可怕的；令人敬畏的；难以对付的
recur|v. 重现；再发生
regularity|n. 规律性；规则性
accomplishment|n. 成就；完成
attainment|n. 达到；获得
inveterate|adj. 根深蒂固的；积习难改的
self-improvement|phrase. 自我提高
scheme|n. 阴谋；计划；v. 密谋；策划
ambitious|adj. 有野心的；有雄心的
pitfall|n. 陷阱；隐患；想不到的困难
modest|adj. 谦虚的；不多的；适度的
assiduously|adv. 刻苦地；不懈地
self-discipline|n. 自律；自我约束
frame|n. 框架；结构；骨架；模式；v. 制定；框住；陷害；表达
betray|v. 背叛；出卖；泄露；暴露
troop|n. 军队（复）；部队（复）；连；队；群；v. 群集；结队；成群前行
unsettle|v. 使心神不宁；使不安；扰乱
taunt|v. 奚落；嘲笑；n. 奚落；嘲笑
jibe|v. 嘲讽；嘲弄；相匹配；n. 嘲弄；挖苦
good-humouredly|adv. 和气地；心情好地
wane|v. 衰落；减弱；缺；亏；n. 衰退；减弱；缺；亏
diminish|v. 减少；削弱；减损；贬低
hypnotize|v. 施催眠术；使（某人）着迷
undoing|n. 解开；祸根；毁灭的原因；v. 解开；撤消；毁掉；“undo”的现在分词
screen|n. 屏幕；屏风；掩蔽物；v. 筛查；掩蔽；放映
notoriously|adv. 臭名昭著地；众所周知地
mainframe|n. 主机；大型计算机
full-time|adj. 全部时间的；专任的
technician|n. 技术员；技师
software|n. 软件
IBM|abbr. （美国）国际商用机器公司；“International Business Machines”的缩写
DOS|abbr. 磁盘操作系统；“Disk Operating System”的缩写
Microsoft|n. （美国）微软公司
user-friendly|adj. 容易操作的；好用的
multimedia|adj. 多媒体的；n. 多媒体
alternative|adj. 供选择的；n. 供替代的选择
diagnose|v. 诊断
relieve|v. 减轻；缓解
accountant|n. 会计；会计师
repetitive|adj. 重复的
clerical|adj. 文书或办事员的；教士的；牧师的
Internet|n. 因特网；互联网
network|n. 网络；网路；网状物
permanent|adj. 永久的；持久的
tint|n.  色彩；浅色；染发剂；v. 给...染色
delicate|adj. 微妙的；易碎的；脆弱的；精致的
shade|n. 荫；遮蔽处；阴影；v. 遮蔽；画阴影
observant|adj. 观察力敏锐的；谨慎遵守的
greyish|adj. 浅灰色的
dispel|v. 驱散；消除；打消
outlandish|adj. 奇异的；古怪的；异国风格的
acquisition|n. 获得；得到的东西；收购
cosmetic|n. 化妆品；美容品；adj. 化妆用的；美容的；装点门面的
fanciful|adj. 想象的；奇怪的；富于幻想的
insoluble|adj. 无法解决的；不能溶解的
prompt|adj. 迅速的；准时的；v. 提示；促使；n. 提示；提词
syllable|n. 音节
bewilderment|n. 困惑；迷乱
freckle|n. 雀斑；小斑点；v. （使）生雀斑
evidently|adv. 显然地
weird|adj. 离奇的；古怪的；怪异的
concoction|n. 混合物；调制品；捏造
intoxicate|v.  使中毒；使醉；使 ...陶醉
discreetly|adv. 谨慎地；小心地
clutch|v. 抓住；攫住；n. 紧抓；离合器；一窝雏；一小群；紧要关头
adorn|v. 装饰；佩戴；使美观
evolve|v. 形成；演变；进化
high-handed|adj. 高压的；专横的
incompetent|adj. 无能力的；不称职的；不能胜任的；n. 没有能力的人
over-zealously|adv. 过分热情地
safeguard|n. 保护措施；v. 保卫；保护
parliamentary|adj. 议会的；国会的
qualified|adj. 有资格的；合格的；有保留的；有限制的；v. 取得资格；“qualify”的过去式和过去分词
grievance|n. 委屈；不满；不平；抱怨
Justiteombudsman|n. （瑞典的）司法特派员
ombudsman|n. 调查官；巡视官；申诉专员
secretive|adj. 遮遮掩掩的；守口如瓶的
correspondence|n. 通信联系；符合；一致
alter|v. 变更；改动
accusation|n. 控告；起诉；指控
ascertain|v. 查明；弄清；确定
prejudiced|adj. 有偏见的；偏爱的；偏心的；v. 使有偏见；损害；“prejudice”的过去式和过去分词
insect|n. 昆虫
wage|n. 工资；v. 发动
contaminate|v. 污染；弄脏
provocation|n. 挑衅；刺激；激怒
spider|n. 蜘蛛
wasp|n. 黄蜂；胡蜂
moth|n. 蛾；蛀虫
ant|n. 蚂蚁
revulsion|n. 剧变；非常的厌恶
horde|n. （熙攘、纷扰的）一大群
uncanny|adj. 神秘的；不可思议的
erase|v. 抹去；擦掉
praying mantis|phrase. 螳螂
entranced|adj. 出神的；着迷的；v. 使出神；使入迷；“entrance”的过去式和过去分词
beetle|n. 甲虫
sheltered|adj. 受保护的； 受庇护的；遮蔽的；v. 庇护；遮蔽；“”的过去式和过去分词
luscious|adj. 美味的；甘美的；满足感官的；性感的
cluster|n. 群；团；簇；v. 聚集
aphid|n. 蚜虫
underside|n. 下侧；底面；下面
colony|n. 殖民地；群体
sticky|adj. 黏的；棘手的
scurry|v. 小步疾走；急赶；n. 快跑声；疾走
swarm|n. 群；蜂群；v. 云集；充满
ingenuity|n. 独创力；聪明才智
astronomy|n. 天文学
relative|n. 亲戚；adj. 比较的；相对的；相关联的
infinitely|adv. 无限地；无穷地；极大地
solar|adj. 太阳的；太阳能的
Venus|n. 金星；维纳斯
Mars|n. 火星
orbit|n. 轨道；v. 绕...轨道而行
astronomical|adj. 天文学的；巨大的
generate|v. 产生；引起；发（热、电）
particle|n. 微粒；粒子
Jupiter|n. 木星；朱庇特
blot|n. 污点；墨渍；v. （用纸或布）吸干；弄脏
analyse|v. 分析
bacteria|n. 细菌；“bacterium”的复数
oxygen|n. 氧；氧气
realm|n. 领域；王国
endeavour|v. 努力；尽力；n. 尝试；努力
boundary|n. 分界线；边界
pump|n. 泵；抽水机；打气机；v. 抽水；打气
overtake|v. 赶上；超过
backwater|n. 回水河汊；死水；穷乡僻壤
predecessor|n. 前任；前辈；原有事物
meadow|n. 草地；牧场
crown|n. 皇冠；王冠；v. 加冕；加顶；使圆满
holly|n. 冬青树
wreath|n. 花圈；花环；圈状物；环状物
occurrence|n. 发生的事；发生
proportion|n. 比例；份额
site|n. 位置；场所
spell|v. 拼写；招致；意味着；顶替；n. 一段时间；咒语；魅力
stall|n. 小隔间；摊位；牲畜棚；v. 停顿；（使）熄火；故意拖延
attic|n. 阁楼；顶楼
sweeping|adj. 大范围的；影响广泛的；全面的；笼统的；v. 扫；打扫；“sweep”的现在分词；n. 扫除
critical|adj. 批判性的；临界的；危急的；关键的；至关重要的
juncture|n. 时刻；关头；接合
raft|n. 木筏；木排；v. 筏运；乘筏
unduly|adv. 过度地；不适当地；过分地
foundations|n. 地基；房基；n. 创建；基础；根据；基金（会）；“foundation”的复数
stoutly|adv. 刚强地；坚决地
submerge|v. 潜水；浸没
grapple|v. 抓住；扭打；搏斗；努力解决；n. 抓钩；扭打；搏斗
alien|n. 外星人；外国人；外侨；adj. 外国的；陌生的；相异的
emigrate|v. 移居国外
absorb|v. 吸收；理解；吸引；使全神贯注；缓冲
embedded|adj. 植入的；嵌入的；v. 使插入；使嵌入；“embed”的过去式和过去分词
mortally|adv. 致命地；非常地
comprehensive|adj. 全面的；广泛的；综合的；详尽的
milestone|n. 里程碑；重要事件
territory|n. 领土；领域
milometer|n. 里程表
spire|n. 尖塔；尖顶；v. 给 ... 装尖顶；塔状矗立
retrace|v. 折回；追溯；沿原路返回；追想
stumble|v. 绊倒；蹒跚；失误 ；n. 绊倒
horizon|n. 地平线；（思想等的）范围；眼界
reservoir|n. 水库；蓄水池
lift|v. 举起；抬起；提起；解除；n. 电梯；搭便车
monstrous|adj. 巨大的；畸形的；恐怖的
negligence|n. 疏忽；过失；失职
prudent|adj. 谨慎的；慎重的；精明的
composure|n. 镇静；镇定；沉着
intruder|n. 闯入者；入侵者
lurk|v. 潜伏；隐藏；n. 潜伏；埋伏
hinder|v. 阻碍；打扰
fingerprint|n. 指纹；指印；v. 采指纹
chaos|n. 混乱
inconceivable|adj. 难以想象的；难以相信的
veritable|adj. 真实的；确实的；真正的
magpie|n. 喜鹊；喜欢收集（无价值物品）的人
toss|v. （随意地）抛掷；向后甩
discard|v. 抛开；遗弃；废弃
constable|n. 警察；警员
ransack|v. 彻底搜索；洗劫
balcony|n. 阳台
fussy|adj. 大惊小怪的；挑剔的；难取悦的
amass|v. 积累；积聚；收集
indiscriminate|adj. 不加选择的；不加区别的；恣意的
clutter|n. 杂乱；混乱；v. 弄乱
string|n. 弦；线；一连串
requisite|adj. 必需的；必备的；必不可少的；n. 必需品
mania|n. 狂热； 癖好；躁狂症
sketch|n. 草图；素描；概述；v. 草拟；速写；简述
remote|adj. 偏远的；久远的；渺茫的；n. 遥控器
strong-minded|adj. 意志坚强的；有主见的
relaxation|n. 放松；消遣；休息
verify|v. 核实；证实
bearing|n. 影响；方位；轴承；举止；v. 忍受；“bear”的现在分词
like-minded|adj. 志趣相投的
specimen|n. 标本；样品
constructively|adv. 建设性地；积极地
contented|adj. 满足的；v. 使满足；“content”的过去式和过去分词
boredom|n. 无聊；厌倦；厌烦
punctuality|n. 准时
rural|adj. 农村的；乡村的
intellectual|adj. 智力的；明智的；有才智的；n. 知识分子
abstruse|adj. 难解的；深奥的
coordinate|v. 协调；使配合；搭配；n. 坐标；adj. （在句子中）并列的；坐标的
reproach|v. 责备；指责；n. 责备；指责
puncture|n. 刺穿；刺孔；v. 刺穿；削弱
diversion|n. 转移；改道；分散注意力；消遣
trial|n. 审判；试验；考验；v. 测试
fraction|n. 小部分；分数
flourish|v. 茁壮成长；繁荣兴旺；挥动；n. 夸张动作
microscopic|adj. 显微镜的；极小的；微观的
adamant|adj. 坚定不移的；固执的