fossil man|phrase. 化石人
recount|v. 细述；叙述；n. 叙述；重新计票
saga|n. 英雄故事
legend|n. 传说；传奇
migration|n. 迁移；迁徙；转移
anthropologist|n. 人类学家
ancestor|n. 祖先；祖宗
Polynesian|adj. 波利尼西亚（人）的；n. 波利尼西亚人
Indonesia|n. 印度尼西亚
archaeologist|n. 考古学家
flint|n. 燧石；打火石
rot|n. 腐烂；腐败；v. （使）腐烂
beast|n. 兽；凶残的人
census|n. 人口普查
acre|n. 英亩
content|n. 内容；含量；目录；adj. 满足的；v. 使满意
Matterhorn|n. 马特霍恩峰（阿尔卑斯山峰之一）
alpinist|n. 登山运动员
pioneer|n. 拓荒者；先驱者；创始者；倡导者；v. 开拓；做先锋；倡导
summit|n. 顶峰；顶点；顶尖；最高级会谈；首脑会议；adj. 最高级的；政府首脑的
attain|v. 达到；获得
perilous|adj. 危险的；艰险的
shudder|v. 战栗；发抖；n. 战栗；震颤
court|n. 法院；球场；宫廷；v. 求爱；献殷勤；招致
solitary|adj. 独自的；单独的；孤寂的
impoverish|v. 使贫困；使贫瘠
Alpine|adj. 阿尔卑斯山的
flea-ridden|adj. 布满跳蚤的
coarse|adj. 粗糙的；粗鲁的
boast|v. 自夸；夸耀；自豪地拥有
parishioner|n. 教区居民
shepherd|n. 牧羊人；牧师；指导者；v. 照看；引领
linen|n. 亚麻布；亚麻织品；adj. 亚麻布制的；亚麻色的
the Alps|n. 阿尔卑斯山脉
solid|n. 固体；立体图形；adj. 固体的；坚固的；可靠的
safe|adj. 安全的
Ulyanovsk|n. 乌里扬诺夫斯克（伏尔加河中游城市）
commission|n. 委员会；佣金；v. 委托；委任
opaque|adj. 不透明的；难懂的；晦涩的
lotto|n. 落托数卡牌戏；乐透（一种赌博游戏）
slipper|n. 拖鞋
blindfold|adj. 眼睛被蒙住的；adv. 眼睛被蒙住地；v. 蒙住 ... 的眼睛；n. 蒙眼物；盲目
leave|v. 离开；离去；留下；n. 休假
fundamentals|n. 基本原则；基本原理；“fundamental”的复数
glorious|adj. 光荣的；辉煌的
splendid|adj. 壮观的；辉煌的；极好的
rub|v. 擦；摩擦；n. 擦；摩擦；阻碍
identity|n. 身份；特性；一致
dreary|adj. 沉闷乏味的；忧郁的；凄凉的
commitment|n. 承诺；奉献
mean|v. 意思是；打算；导致；有意；对…严肃认真；adj. 低劣的；吝啬的；平均的；n. 平均数；中庸；居中
social climber|phrase. 追求更高社会地位的人；向上爬的人
devotion|n. 献身；热爱；奉献
cosmic|adj. 宇宙的；极广阔的
suburban|adj. 市郊的；郊区的；见识不广的
conceited|adj. 自负的；骄傲自大的
presumptuous|adj. 放肆的；冒昧的；自以为是的
fatuous|adj. 愚昧的；昏庸的；愚笨的
cliché|n. 陈词滥调
goodwill|n. 善意；友好；商誉
cricket|n. 板球；蟋蟀
inclination|n. 倾斜；倾向；意向
contest|n. 比赛；竞赛；v. 竞争；争夺；争辩；辩驳
orgy|n. 狂欢；放荡；纵欲
deduce|v. 推断；演绎；推论
competitive|adj. 竞争的；有竞争力的
patriotism|n. 爱国主义；爱国精神
disgrace|n. 耻辱；丢脸；不光彩；v. 使丢脸；使蒙受耻辱
savage|adj. 野性的；凶猛的；荒野的；n. 野蛮人；粗人；凶恶的人；v. 凶狠地攻击；激烈抨击
combative|adj. 好斗的
mimic warfare|phrase. 模拟战争
behaviour|n. 行为；举止；表现
absurd|adj. 荒唐的；荒唐可笑的；n. 荒诞的事物
bat|n. 蝙蝠；球拍；球棒；v. 击（球）
strictly|adv. 严格地；仅限于；完全地
utilitarian|adj. 实用的；功利的；n. 功利主义者
appreciation|n. 欣赏；感激；理解
obstruction|n. 障碍；妨碍；闭塞；违例阻挡
elapse|v. 逝去；过去；n. （光阴）逝去
hull|n. 外壳；皮；船身；船体；v. 去壳
interval|n. 间隔；中场休息
receipt|n. 收据；收条
apparatus|n. 装置；仪器；器械；器官
shoal|adj. 浅的；n. 浅水处；鱼群；一大群；v. （使）变浅
herring|n. 青鱼；鲱鱼
cod|n. 鳕鱼；鳕鱼肉
squeak|n. 吱吱声；尖叫声；v. 短促而尖厉地叫；吱吱叫
slaughter|v. 屠宰；屠杀；n. 屠宰；屠杀
fit|adj. 健康的；适合的；v. 符合；合身
grace|n. 优雅；恩宠
tariff|n. 关税；税率；（旅馆、饭店等的）价目表
standard|n. 标准；adj. 标准的；规范的；权威的
dialysis|n. 透析；渗析
electrocute|v. 使触电身亡
eliminate|v. 消除；排除；淘汰
accord|v. 符合；一致；给予；n. 协议；条约；协调
device|n. 设备；装置；手段；策略；方法
hammer out|phrase. 推敲； 苦心想出
pact|n. 契约；协定；条约
espionage|n. 间谍活动
Alfred|n. 阿尔弗雷德
Danish|adj. 丹麦的；丹麦人的；丹麦语的；n. 丹麦语
minstrel|n. （中世纪）吟游诗人
wandering|adj. 漫游的；流离的；流浪的；v. 徘徊；漫游；“wander”的现在分词
harp|n. 竖琴；v. 反复诉说；唠叨
ballad|n. 民谣；歌谣；民歌
acrobatic|adj. 杂技的；特技的
conjuring|n. 魔术；v. 变戏法；施魔法；念咒召唤；“conjure”的现在分词
Athelney|n. 阿塞尔纳（英国一个小岛）
Chippenham|n. 切本哈姆（英国一城市）
thither|adj. 对岸的；那边的；adv. 到那处；向那方
Dane|n. 丹麦人；戴恩（男子名）
slack|adj. 松弛的；懈怠的；萧条的；n. 松弛的部分；松散；淡季；v. 使松弛；懈怠
conqueror|n. 征服者；占领者
casual|adj. 偶然的；随意的；非正式的；临时的；不定的
precaution|n. 预防；预防措施
proceeds|n. 收益；v. 进行；继续；继续进行；“proceed”的第三人称单数
assemble|v. 装配；集合
trivial|adj. 不重要的；琐碎的；微不足道的
prolonged|adj. 持久的；长时期的
commissariat|n. 军需处；粮食；粮食补给
harry|v. 不断骚扰；打扰；侵扰
assail|v. 攻击；困扰；抨击；袭击
skirmish|n. 小规模战斗；小争斗；小冲突；v. 进行一场小冲突
episode|n. 一集；事件；一段经历；一段时期
epic|n. 史诗；叙事诗；adj. 史诗的；叙事诗的；宏丽的
silicon|n. 硅
integrated|adj. 综合的；整合的；融合的；v. 整合；结合；“integrate”的过去式和过去分词
circuit|n. 回路；环行；电路；巡回；v. 环行
California|n. 加利福尼亚
workstation|n. 工作站
chip|n. 炸薯条；芯片；碎片；v. 削成碎片；碎裂
newsletter|n. 时事通讯；业务通讯；简报
Macintosh|n. 麦金塔计算机
penalize|v. 对…予以惩罚；使处于不利地位
customize|v. 定制； 用户化
spawn|n. 卵；产物；v. 产卵
thrive|v. 兴旺；繁荣；茁壮成长
anarchy|n. 无政府状态；无秩序；混乱
oriental|adj. 东方的（尤指中国和日本）
constitute|v. 构成；被视为；成立
drove|n. 被驱赶的畜群；v. 驾驶；驱使；“drive”的过去式
innovator|n. 革新者；创新者
forge|v. 伪造；制造；建立（联系等）；n. 锻造车间
memory-chip|n. 存储芯片；内存芯片
AT&T|abbr. 美国电话电报公司；“American Telephone and Telegraph”
Kansas|n. 堪萨斯（美国）
Missouri|n. 密苏里州（美国州名）
oppress|v. 压迫；使烦恼
justification|n. 辩护；正当的理由
justifiably|adv. 言之有理地；无可非议地
cheat|n. 骗子；作弊者；v. 欺骗；作弊
abject|adj. 卑鄙的；下贱的；凄惨的
ignoble|adj. 平民的；卑贱的；卑鄙的；不光彩的
impersonal|adj. 不受个人感情影响的；没有人情味的；非特指某一人的；客观的
ego|n. 自我；自负；自尊心
recede|v. 后退；减弱；退出（某种活动）
increasingly|adv. 愈加；日益
passionately|adv. 激昂地；热烈地
painlessly|adv. 无痛地；不难地；不费力地
vitality|n. 活力；生命力
weariness|n. 疲倦；疲劳
current|n. （水、气、电）流；趋势；adj. 当前的；流通的
account|n. 账户；叙述；账目；v. 说明；占…
cash|n. 现金
cheque|n. 支票
debtor|n. 债务人；借方
creditor|n. 债权人；债主
obligation|n. 义务；责任
complication|n. 复杂；并发症
debit|n. 借方；借记；v. 借记
specimen|n. 标本；样品
forgery|n. 伪造；伪造罪；伪造物
adopt|v. 收养；采用；采纳；正式通过
facilitate|v. 使容易；使便利；促进；帮助
mineral|n. 矿物；矿物质
boring|adj. 无聊的；令人厌倦的；v. 开凿；钻孔；使厌烦； “bore”的现在分词
derrick|n. 起重机；钻塔；井架
block and tackle|phrase. 滑轮组；滑车组
haul|v. 拖；拉；拖运；n. 拖；拉；拖运
rotate|v. 转动；轮作；轮流
cutting bit|phrase. 钻头
geologist|n. 地质学家
coring bit|phrase. 取芯钻头
cylinder|n. 圆柱；圆筒；汽缸
strata|n. 岩层；地层；社会阶层；“stratum”的复数
circulate|v. 循环；流通；散布
gusher|n. 喷油井
forecast|n. 预测；预报；v. 预测；预报
speculative|adj. 推测的；推理的；思索的；投机的
blizzard|n. 暴风雪；大量
deteriorate|v. 恶化；变坏；退化
multiply|v. 乘；增加；繁殖
cascade|n. 瀑布；成下垂状的东西；大量；v. 飞流直下；悬挂
turbulent|adj. 狂暴的；骚动的；动荡的；汹涌的
dust devil|phrase. 小尘暴；尘旋风
squall|n. 狂风；暴风雪；大喊大叫；v. 狂风吹袭；哇哇地叫嚷
eddy|n. 漩涡；涡流；v. 起漩涡；旋转；杂乱无章地移动
grid|n. 网格；格栅；方格；系统网络
sensor|n. 传感器；敏感元件
humidity|n. 湿度；湿气
meteorologist|n. 气象学家
Princeton|n. 普林斯顿（美国城市名）
New Jersey|n. 新泽西（美国）
fluctuation|n. 波动；起伏
deviation|n. 偏离；出轨；背弃
secrecy|n. 秘密；保密；隐蔽
effectiveness|n. 有效性；效力
inquiry|n. 调查；询问
positive|adj. 积极的；正面的
process|n. 过程；进程；工序；v. 处理；加工
patent|n. 专利；专利权；专利证书；adj. 有专利的；受专利保护的
agent|n. 代理人；经纪人；动因；特工；（药）剂
physiological|adj. 生理学的
maximum|n. 最大限度；最大量；adj. 最多的；最大极限的
consideration|n. 考虑；体贴；报酬
descendant|n. 后裔；子孙；后代
artificial|adj. 人造的；人工的；假的
impose|v. 强加；征收；施加影响；利用；强制实施
dimension|n. 尺寸；维度
skyscraper|n. 摩天大楼
tenant|n. 房客；租户；佃户
civilized|adj. 文明的；开化的；有法制伦理的；v. 使开化；使文明；教化；“civilize”的过去式和过去分词
banal|adj. 平庸的；平淡无奇的；陈腐的
luxury|n. 奢华；奢侈品；难得的享受
deprive|v. 剥夺；使丧失
monstrous|adj. 巨大的；畸形的；恐怖的
edifice|n. 大厦；大建筑物
toxic|adj. 有毒的；中毒的；n. 毒物；毒剂
ceaselessly|adv. 不停地
throng|n. 人群；一大群；众多；v. 群集；挤满；涌进
settlement|n. 解决；协议；定居（过程）；定居点
enterprising|adj. 有事业心的；有进取心的；有魄力的
settler|n. 移民者；殖民者
Antipodes|n. 澳（大利亚和）新（西兰）
promiscuous|adj. 淫乱的；滥交的；杂乱的
abandon|v. 抛弃；放弃；中止
overrun|v. 超过（范围）；侵占；泛滥
devastation|n. （大面积的严重）破坏；极度震惊或悲伤
burrow|v. 挖洞；钻进；翻寻；n. 地洞
susceptible|adj. 易受影响的；易动感情的
virus|n. 病毒
myxomatosis|n. 多发性粘液瘤
infect|v. 传染；感染
epidemic|n. 流行病；adj. 流行性的
mosquito|n. 蚊子
carrier|n. 病毒携带者；运输公司；运输工具
exterminate|v. 消灭；灭绝；根除
ironically|adv. 讽刺地；说反话地
bequeath|v. 遗赠；遗留；把…传下去
pest|n. 害虫
pestilence|n. 瘟疫；毒害物
confine|v. 限制；监禁
domesticate|v. 驯养；使爱家；适应家庭生活
porpoise|n. 鼠海豚
mariner|n. 海员；水手
shark|n. 鲨鱼
formation|n. 形成；排列方式
dolphin|n. 海豚
unconscious|adj. 无知觉的；无意识的
beaver|n. 海狸；海狸毛皮；v. 勤奋工作
ashore|adv. 在岸上；到岸上
waterlogged|adj. 浸满水的；进了水的
scent|n. 香味；香水；气息；察觉；v. 嗅出；使充满气味；觉察出
ensue|v. 接着发生；因而产生
intrigue|v. 密谋；激起…的兴趣；n. 阴谋诡计；密谋策划
indignity|n. 侮辱；侮辱性言行
snout|n. 鼻口部；猪嘴；鼻状物
shove|v. 挤；推；撞
aquaplane|n. 滑水板；v. 乘滑水板滑水
oceanarium|n. 海洋水族馆
swoop|n. 突降；猛扑；v. 突降；猛扑
belly|n. 腹部；肚子
equilibrium|n. 平衡；均衡；平静
butt|n. 烟蒂；屁股；枪托；笑柄
crack|n. 裂缝；裂纹；噼啪声；v. 断裂；破裂；打击；使崩溃
speculation|n. 推测；猜测；投机买卖
literally|adv. 字面上；逐字地；确实地
odd|adj. 奇怪的；奇数的；不成对的；不经常的；adv. （用于数字后）大约
tissue|n. 组织；纸巾；薄纸
plausible|adj. 看似真实的；似乎可信的；似乎合理的
hypothesis|n. 假设；假说
electroencephalograph|n. 脑电图仪
electrode|n. 电极
scalp|n. 头皮；v. 剥头皮
psychiatrist|n. 精神病学家；精神科医生
punctuate|v. 加标点于；强调；不时打断
jerky|adj. 急动的；颠簸的；抽筋的；n. 肉干
disorder|n. 混乱；无秩序；失调
implication|n. 可能的影响（或后果）；暗示；含意；牵连
saliva|n. 唾液；口水
digestive|adj. 消化的；助消化的
defy|v. 不服从；藐视；挑衅
analysis|n. 分析；剖析
prey|n. 猎物；受害者；受骗者；v. 捕食；坑害；折磨
fierce|adj. 凶猛的；凶狠的
tussle|n. 扭打；斗争；v. 扭打；打斗
carnivore|n. 食肉动物；食虫植物
vertebrate|adj. 有脊骨的（动物）；n. 脊椎动物
lizard|n. 蜥蜴
concoct|v. 调制；捏造
potency|n. 效力；潜能
conversion|n. 转换；转化；改变信仰
arsenic|n. 砷；砒霜；adj. 砷的；含砷的
strychnine|n. 马钱子碱；士的宁
mamba|n. 树眼镜蛇；曼巴蛇
cobra|n. 眼镜蛇
venom|n. 毒液；愤恨
neurotoxic|adj. 毒害神经的
viper|n. 蝰蛇；毒蛇；阴险恶毒的人
adder|n. 蝰蛇
rattlesnake|n. （美洲的）响尾蛇
haemolytic|adj. 溶血性的
viperine|adj. 毒蛇的；似毒蛇的
supreme|adj. 至上的；最高的
protagonist|n. 主角；支持者
outlaw|n. 亡命之徒；逃犯；被剥夺法律权益者；v. 宣布…为非法；使…成为非法
framed|adj. 遭到陷害的；v. 制定；把 ... 框起来；陷害；“frame”的过去式和过去分词
vicious|adj. 邪恶的；恶毒的；堕落的
mythology|n.  神话；神话学；神话集
vanished|adj. 消失了的；v. 销声匿迹；突然消失；“vanish”的过去式和过去分词
absurdly|adv. 荒诞地
arena|n. 竞技场；舞台
encroaching|adj. 渐渐渗入的；v. 侵入；侵占；侵犯；侵蚀；“encroach”的现在分词
Indian|adj. 印度的；印第安人的；n. 印度人；印第安人
bewilder|v. 使迷惑；使...不知所措
alien|n. 外星人；外国人；外侨；adj. 外国的；陌生的；相异的
taboo|n. 禁忌；忌讳；戒律；adj. 禁忌的；忌讳的；v. 禁忌
disinherit|v. 剥夺（某人）的继承权
undeclared|adj. 未经宣布的；不公开的；未报关的
hypocrisy|n. 伪善；虚伪；造作
chicanery|n. 欺诈；欺骗
impending|adj. 即将发生的；迫在眉睫的；v. 迫近；逼迫；即将发生；“impend”的现在分词
immolation|n. 供奉牲礼；牺牲；祭物
code|n. 代码；密码；编码；行为准则；法典；法规；v. 编码
loom|n. 织布机；若隐若现；v. 隐约可见；迫近
manifest|v. 表明；显现；使人注意到；adj. 明显的；n. 载货单；旅客名单
morality|n. 道德；道义
communicate|v. 沟通；交流
compound|n. 化合物；大院；adj. 复合的；混合的；v. 使复杂化；加重
enhance|v. 提高；增强
tempo|n. 拍子；节奏；速度
trickle|v. 滴流；慢慢移动；n. 细流；徐徐地流
torrent|n. 急流；激流；湍流；一连串
humanity|n. 人性；人类；人道；仁慈
indifferently|adv. 冷淡地；不在乎地；淡然地
grimly|adv. 可怕地；严肃地；坚强地；冷酷地
whimsical|adj. 异想天开的；古怪的；反复无常的
shatter|v. 使粉碎；使破碎；使破灭；n. 碎片
twofold|adj. 有两部分的；双重的；两倍的；adv. 两部分地；双重地；两倍地
albatross|n. 信天翁
sustenance|n. 食物；营养；维持生计
glider|n. 滑翔机
harness|n. 马具；挽具；v. 套马具；驾驭；利用；治理
endow|v. 捐赠；资助；赋予
ply|n. 一层；一股；厚度；v. 定期往返；不断做；不断供应
gale|n. 大风；一阵（喧闹）
partridge|n. 鹧鸪；山鹑
like|v. 喜欢；prep. 像
propulsion|n. 推进；推动力
utter|v. 说出；出声；adj. 完全的；十足的
slip|v. 滑倒；滑落；溜走；悄悄地放；n. 滑倒；溜走；疏忽；纸片
adverse|adj. 不利的；有害的；相反的；敌对的
omen|n. 征兆；预兆
intense|adj. 强烈的；剧烈的；紧张的
aesthetic|adj. 审美的；美学的
realm|n. 领域；王国
serenity|n. 安详；宁静
undeniable|adj. 不可否认的；无可辩驳的
indefinable|adj. 难下定义的；难以说明的；不确定的
vulgar|adj. 庸俗的；粗俗的；粗野的；下流的
radiance|n. 光辉；辐射
intimation|n. 暗示；通知
unutterable|adj. 难以言表的；说不出的
invest|v. 投资；投入
auditory|adj. 听的；听觉的
inadequate|adj. 不充分的； 不足的；能力不足的
plea|n. 恳求；申诉；抗辩；借口
abatement|n. 减少；减轻；缓和
discredit|n. 不信任；名誉丧失；信誉丧失；v. 不信；败坏名声；使丢脸
allegation|n. （无证据的）说法；指控
caption|n. 插图说明；标题；字幕；v. 加上说明；加上标题；加上字幕
wreck|v. 破坏；毁坏；n. 遇难船只；失事；残骸
snag|n. 小困难或障碍；划破处；钩丝处；v. 被钩住；划破；抢先获得
anecdote|n. 趣闻；轶事
slander|v. 诋毁；诽谤；中伤；n. 诋毁；诽谤；中伤
persecute|v. 迫害；烦扰
squadron|n. （空军或海军的）中队
psychiatric|adj. 精神病的；精神病学的
diagnosis|n. 诊断
orphanage|n. 孤儿院
preservation|n. 保存；维持
silt|n. 淤泥； 淤积；v. 使淤塞
scavenger|n. 食腐动物；拾荒者
vole|n. 田鼠
decompose|v. 分解；使腐烂
inaccessible|adj. 难以达到的；无法接近的
crevasse|n. 裂缝；裂隙
Siberian|adj. 西伯利亚的；n. 西伯利亚人
palaeontological|adj. 古生物的
St. Petersburg|n. 圣彼得堡
sabre-toothed|adj. 长着锐利的长犬牙的；剑齿的
venture|v. 冒险；投机；n. 冒险事业；商业冒险；投机
bogged|adj. 陷入泥沼的；陷于困境的；v. （使）陷入泥沼； （使）陷入困境；“bog”的过去式和过去分词
galleon|n. （15–17世纪使用的）西班牙大帆船
Stockholm|n. 斯德哥尔摩（瑞典首都）
flagship|n. 旗舰
imperial|adj. 帝国的；皇帝的；英制的（度量衡）
hurricane|n. 飓风
armament|n. 军备；武器；备战
triple|adj. 三部分的；三方的；三倍的；n. 三倍的数；三个一组；v. 成为三倍；使增至三倍
mount|v. 逐渐增加；骑上；登上；装上；安放；n. 山；峰
bronze|n. 青铜；青铜色；adj. 青铜色的
cannon|n. 大炮；火炮；v. 猛撞；碰撞
might|v. 可能；也许；应该；“may”的过去式；n. 威力；强大力量
ferment|n. 发酵；酵素；动乱；v. （使）发酵；动乱
ornament|n. 装饰；装饰品；v. 装饰；美化
riot|n. 骚乱；暴乱
demon|n. 魔鬼；恶魔；精力充沛的人；高手
mermaid|n. 美人鱼
cherub|n. 小天使
zoomorphic|adj. 兽形的
ablaze|adj. 着火的；闪耀的；激动的
portray|v. 描写；描绘；饰演
drifting|adj. 弥漫的；v. 漂移；漂流；“drift”的现在分词
churn|v. 剧烈搅动；（使）猛烈翻腾；n. 搅乳器
pennant|n. （船上用作信号等的）三角旗；（奖给棒球等联赛优胜队的）锦旗
superstructure|n. 上层结构；上部构造
majestic|adj. 宏伟的；壮丽的；威严的
muzzle|n. 动物之鼻口；口套；枪口；v. 戴口套于；使缄默
freshen|v. 变新鲜；使洁净；使有精神
list|n. 表；名单；v. 列出；（船）倾斜
port|n. 港口
ordnance|n. 军械；军需品
heave|v. 举起；投掷；起伏；喘息；呕吐；n. 举；投；掷；起伏；喘息；呕吐
starboard|n. 右侧；adj. （在）右舷的
counteract|v. 抵制；中和；对抗
steepen|v. 使陡峭
ballast|n. 压舱物；镇重物； 镇流器；道碴；v. 在…上装镇压物
inrush|n. 涌入；侵入
Baltic|adj. 波罗的海的；波罗的语的
sceptical|adj. 怀疑的
forefathers|n. 祖先；“forefather”的复数
fervently|adv. 热心地；热诚地
curative|adj. 医疗的；治疗的；n. 药品
astronomical|adj. 天文学的；巨大的
tangible|adj. 可触摸的；实际的；有形的；确凿的
remedy|n. 疗法；纠正办法；v. 纠正；治疗
ointment|n. 药膏；油膏；软膏
prescribe|v. 开药方；规定
indisposition|n. 小病；不舒服；厌恶
disgusting|adj. 令人厌恶的；令人作呕的；v. 使厌恶；使作呕；“disgust”的现在分词
inconvenience|n. 不便；困难；v. 使 ... 不便；使 ... 困难
hovercraft|n. 气垫船
Norfolk Broads|n. 诺福克郡的湖泊地区
cushion|n. 靠垫；软垫；缓冲物；v. 加衬垫；对…起缓冲作用；减轻…
ring|n. 环；环形物；戒指；铃声；声调；拳击场；v. 成环形；环绕；响铃；鸣；给…打电话
Solent|n. 索伦特海峡
sensation|n. 感觉；知觉；轰动
dune|n. 沙丘
plantation|n. 耕地；种植园
hovertrain|n. 气垫列车
navigation|n. 导航；航行；航海
sounding|n. 发声；（测）水深；adj. 响亮的；夸大的；v. 响；听起来；“sound”的现在分词
fathom|n. 英寻（长度单位）；v. 测深；推测；揣摩；搞懂；彻底了解
porcupine|n. 豪猪；箭猪
dredge|v. 疏浚；挖掘；n. 挖泥船；疏浚机
expedition|n. 远征；探险；探险队；短途旅行；迅速
physicist|n. 物理学家
magnitude|n. 重要性；巨大；震级
topography|n. 地形学；地形；地势
crust|n. 外壳；硬壳；面包皮；地壳
rugged|adj. 崎岖的；粗犷的；粗鲁的；结实耐用的
tableland|n. 高原；台地
sediment|n. 沉积物；沉淀物
terrace|n. 平台；梯田；阳台；v. 使成台地
erode|v. 侵蚀；腐蚀；逐渐丧失；削弱
colour-blind|adj. 色盲的
perception|n. 感知；看法；洞察力
comprehend|v. 理解；领会；包含
spatial|adj. 空间的
visualize|v. 使可见；使形象化；设想
reminiscence|n. 回忆；追忆
tadpole|n. 蝌蚪
mushroom|n. 蘑菇；v. 迅速增长
carrot|n. 胡萝卜
bud|n. 芽；蓓蕾；v. 发芽
lark|n. 云雀；百灵鸟；玩乐；嬉戏
ladybird|n. 瓢虫
bulrush|n. 芦苇；香蒲
controversy|n. 争论；论战
dust|n. 粉尘；尘埃；v. 擦去…的灰尘
clash|n. 碰撞；撞击声；冲突；v. 发出（金属）撞击声；猛撞；冲突
Inquisition|n. （罗马天主教的）宗教法庭
perspective|n. 视角；观点；（对事物的）合理判断；透视；（远）景
despise|v. 鄙视；蔑视；看不起
Aristotelian|adj. 亚里士多德的；亚里士多德哲学的；n. 亚里士多德学派的人
Aristotle|n. 亚里士多德
Ptolemy|n. 托勒密（公元2世纪的古希腊天文学家）
Leaning Tower of Pisa|n. 比萨斜塔
generalize|v. 概括；归纳；泛论；推广
undercurrent|n. 暗流；潜流
theoretical|adj. 理论的
potentiality|n. 潜力；潜在性
intimate|adj. 亲密的；私密的
familiarity|n. 熟悉；通晓；亲近
culpable|adj. 该责备的；有罪的
spiral|n. 螺旋形；陡升或骤降；v. 螺旋式上升（或下降）；adj. 螺旋形的
nebula|n. 星云
scratch|v. 抓搔；刮；n. 抓痕；刮伤
contrivance|n. 发明；设计；发明物
distort|v. 扭曲；歪曲；使变形
purchasable|adj. 可买的；可收买的
preacher|n. 传教士
defendant|n. 被告人；被诉方；adj. 被告的；辩护的
outlook|n. 景色；前景；观点；人生观
capacity|n. 容量；容积；能力；身份；地位；资格
democratic|adj. 民主的
tribal|adj. 部落的；部族的
tribe|n. 部落；部族
illiterate|adj. 文盲的；无知的；n. 文盲；无知识的人
compulsory|adj. 强制的；必须做的
deem|v. 认为；觉得
means|n. 手段；方法；收入；财富；v. 意思是；表示…的意思；“mean”的第三人称单数
hamper|v. 阻碍；妨碍；n. （带盖）篮子
savannah|n. 大草原
juvenile|adj. 青少年的；幼稚的；n. 少年
delinquency|n. （常指青年人的）犯罪
adolescence|n. 青春期
slur|v. 含混不清地说话；诋毁；诽谤；n. 诽谤；诋毁；污辱
adolescent|n. 青少年；adj. 青少年的；青春期的
disloyalty|n. 不忠
spiteful|adj. 恶意的；怀恨的
disillusionment|n. 不再抱幻想；幻想破灭
evaluation|n. 评价；评估；估价
infallibility|n. 绝对正确；绝无错误
resent|v. 愤恨；憎恶；怨恨
sincerity|n. 真诚；诚实；诚挚
victorian|adj. 维多利亚时代的 ；n. 维多利亚时代的人
retreat|v. 撤退；退却；n. 撤退；退却；静居处
unreasoning|adj. 不理智的；无理性的
authoritarian|adj. 专制的；独裁的；n. 独裁主义者；权力主义者
cow|n. 母牛；奶牛；大型母兽；v. 威胁；吓唬
hub|n. 轮轴；轮毂；中心
lunar|adj. 月球的；月亮的；阴历的
oxygen|n. 氧；氧气
Apollo|n. 阿波罗（太阳神）
accelerate|v. 加速；加快
terrestrial|adj. 陆地的；地球的；类似地球的；陆栖的
permanently|adv. 永久地
fascination|n. 迷惑力；魅力
senior|adj. 高级的；年长的；资深的；n. 上司；年长者；大四学生
chasm|n. 裂口；深坑；显著差别
canyon|n. 峡谷
disunited|adj. 分裂的；不和的；v. 使分离；使不和；“disunite”的过去式和过去分词
correspondingly|adv. 相应地
backward|adv. 向后地；adj. 向后的
incur|v. 招致；遭受
administer|v. 管理；执行；实施；给予（药物或治疗）
administrative|adj. 管理的；行政的
analogous|adj. 相似的；类似的
overheads|n. （企业的）一般管理费用；“overhead”的复数
initiative|n. 自发性；主动权；倡议；措施
checker|n. 检验员；审核员；检验机；方格图案；v.  使呈现方格图案或不同颜色
foreman|n. 领班；工头；陪审团主席
dividend|n. 被除数；股份红利；股息
unduly|adv. 过度地；不适当地；过分地
likelihood|n. 可能性
infant|n. 婴儿；幼儿；adj. 婴儿的；幼儿的；初期的
vulnerable|adj. 脆弱的；易受伤的
imperceptible|adj. 感觉不到的；极细微的
steep|adj. 陡峭的；急剧升降的；v. 浸；泡
ageing|n. 变老；老化；adj. 变老的；老化的；v. 变老；“age”的现在分词
odds|n. 几率；可能的机会；不平等；差别
virtual|adj. 几乎的；实际上的；事实上的；虚拟的
robust|adj. 强健的；强壮的；结实的
organism|n. 生物体；有机体；有机组织
thermodynamics|n. 热力学
moot|adj. 未决议的；有讨论余地的；v. 提出…供讨论
run-down|adj. 破旧的；精疲力尽的；耗尽的；n. 扼要报告；描述细节；详细情况；缩减
friction|n. 摩擦；不和；争执
contamination|n. 污染；污秽
sanitation|n. 公共卫生；卫生设施
sewage|n. 污水；污物；下水道
leakage|n. 泄漏
intermittent|adj. 断断续续的；间歇的
carbonated|adj. 碳化的；碳酸的；含二氧化碳的
acidic|adj. 酸的；酸性的
alcohol|n. 酒精；乙醇；含酒精的饮料
disinfectant|n. 消毒剂
sterilize|v. 消毒；灭菌；使绝育
ethanol|n. 乙醇；酒精
bactericidal|adj. 杀菌的
negligible|adj. 可以忽略的；微不足道的
methylated|adj. 甲基化的；v. 甲基化；“methylate”的过去式和过去分式
confess|v. 承认；忏悔
inspiration|n. 灵感；鼓舞；启发
Kashmir|n. 克什米尔
interweave|v. 使交织；使混杂
afresh|adv. 重新；再度
discern|v. 辨明；识别；洞悉
indescribable|adj. 难以形容的；无法描述的
blur|v. 使模糊；使看不清；弄污；n. 模糊
yeast|n. 酵母（菌）
interminably|adv. 没完没了地
winkle|n. 滨螺；玉黍螺；v. 挑出；剔出；设法搞到；逐出
incidentally|adv. 附带地；偶然地；顺便地
pertinent|adj. 中肯的；相关的；切题的
flirt|v. 调情；轻率地对待；n. 与多人调情的人
inmost|adj. 最内部的；最深入的；深藏的；“inner”的最高级
signature|n. 签名
infinity|n. 无限；无穷
ray|n. 光线；光束
energize|v. 赋予能量；使精力充沛；激励
rhythm|n. 节奏；韵律
transmit|v. 发送；传播；传递
exquisite|adj. 精美的；细腻的；强烈的
phenomena|n. 现象；“phenomenon”的复数
crest|n. 冠；顶部；v. 到达顶部；到达最高点
trough|n. 槽；水槽；饲料槽
vertical|adj. 竖的；垂直的
horizontal|adj. 水平的
actuality|n. 实际；真实
catastrophic|adj. 灾难性的
particle|n. 微粒；粒子
maturity|n. 成熟；成年
undulate|v. 使波动；使起伏；adj. 波动的；起伏的
tremor|n. 震动；震颤
gravitational|adj. 引力的；重力引起的
technique|n. 技术；工艺；技巧；技艺
tough|adj. 强硬的；艰苦的；严厉的
resentful|adj. 怨恨的；愤慨的
assign|v. 分配；指派
mahout|n. 象夫
calf|n. 小牛；牛犊；小腿肚
pine|n. 松树；松木；v. 渴望；苦思
underline|v. 在…下面划线；强调
keep|v. 继续；保持；保留
subservient|adj. 卑屈的；恭顺的；次要的；从属的
plunge|v. 投入；跳入；n. 跳进；骤降
tame|adj. 驯化的；温顺的；枯燥无味的；v. 驯养；制服；控制
tether|n. 系绳；系链；界限；v. 用绳拴住
ticklish|adj. 怕痒的；难对付的；棘手的
alarming|adj. 使人惊恐的；引起恐慌的；v. 使惊恐；“alarm”的现在分词
accompaniment|n. 伴随物；伴奏
soothe|v. 使安静；安慰；使缓和
chant|n. 圣歌；赞美诗；喊叫；v. 吟唱；诵扬；反复叫喊
reinforce|v. 增强；增援；加强；加固
endearing|adj. 惹人喜爱的；v. 使受喜爱；“endear”的现在分词
epithet|n. 性质描述词；绰号；称号；表述词语
blandishment|n. 奉承；哄诱
lash|n. 鞭子；鞭打；睫毛；v. 鞭打；摆动；抨击
curl|v. 卷；蜷缩；n. 卷曲
earthquake|n. 地震
slumber|v. 睡眠；n. 睡眠（常复数）
ninepin|n. 九柱戏中的木柱
rigid|adj. 坚硬的；严格的；刻板的；僵直的
delicate|adj. 微妙的；易碎的；脆弱的；精致的
seismometer|n. 地震仪
penholder|n. 笔杆；笔架
legibly|adv. 字迹清楚地；易读地
drum|n. 鼓；v. 敲打
wriggle|n. 蠕动；扭动；蜿蜒；v. 蠕动；扭动；蜿蜒前进
bluebottle|n. 蓝丽蝇；矢车菊
graph|n. 图表；曲线图
graphic|adj. 生动的；图表的；n. 图表
longitudinal|adj. 经度的；纵向的；长度的
transverse|adj. 横向的；横放的；横切的；n. 横向物；横断面
Mercury|n. 水星
hydrogen|n. 氢
prevailing|adj. 普遍的；盛行的；有优势的；v. 获胜；盛行；劝服；“prevail”的现在分词
radio astronomer|phrase. 射电天文学家
uniquely|adv. 独特地；唯一地；珍奇地
rational|adj. 理性的；理智的；合理的
radio frequency|phrase. 无线电频率；射频
cm|abbr. 厘米；“centimetre”的缩写
megacycle|n. 兆周
emission|n. 散发；排放；放射
interstellar|adj. 星际的
rendezvous|n. 约会；约会地点；汇合点；v. 汇合；集合
encounter|v. 遭遇；遇到；邂逅；n. 遭遇；遭遇战
commonplace|adj. 普通的；平庸的；n. 平凡的事
aberrant|adj. 脱离正道的；脱离常轨的
predominant|adj. 主导的；支配的；占有优势的；显著的；主要的
pristine|adj. 原始的；纯洁的；崭新的
stereotype|n. 刻板印象；陈规老套；v. 对…存有成见；把…模式化
vernacular|adj. 本国的；地方的；n. 方言；土语
accommodation|n. 住处；工作场所；停留处；膳宿；（交通工具内的）空间
incumbent|adj. 负有义务的；在职的；n. 在职者；教区牧师
preliminary|adj. 预备的；初步的
proposition|n. 命题；建议；主张
preferential|adj. 优先的；优待的；特惠的
controversial|adj. 有争议的
cactus|n. 仙人掌
termite|n. 白蚁
variant|adj. 相异的；各种各样的；不定的；n. 变体；变种；变形
barbarian|n. 野蛮人；adj. 野蛮的
pagan|n. 异教徒；无宗教信仰者；adj. 异教的；异教徒的；无宗教信仰的
sophistication|n. 老练；精明；精密
premise|n. 前提；假定；v. 提出...作为前提
supernatural|adj. 超自然的；神奇的
dispute|n. 纠纷；争端；v. 对（某事）有异议；争执
subdue|v. 征服；克制；制服
drainage|n. 排水；排水系统；放水
envision|v. 想象；设想
Morocco|n. 摩洛哥
latitude|n. 纬度；行动或言论的程度
heretic|n. 异教徒
conceive|v. 构思；设想；怀孕
suffice|v. 足够；足以；使满足
nuclear|adj. 原子能的；核能的
original|n. 原件；原稿；adj. 原来的；原版的；新颖的；有创造性的
gifted|adj. 有才华的；有天赋的
psychologist|n. 心理学家；心理学研究者
spasm|n. 痉挛；抽搐；一阵发作
futile|adj. 无用的；徒劳的；没出息的
insinuate|v. 暗示；迂回
convulsive|adj. 痉挛的
illumination|n. 照明；启示
undue|adj. 过度的；不适当的
grip|v. 紧握；掌握；吸引；n. 紧握；掌握；控制；把手
recuperation|n. 恢复；康复
improvise|v. 即兴创作；即兴表演；临时准备
sedulously|adv. 孜孜不倦地
vivify|v. 使有生气；使生动活泼
aggravate|v. 加剧；使恶化；激怒
trifling|adj. 微不足道的；无关紧要的；v. 闹着玩；玩弄；“trifle”的现在分词
gratify|v. 使满足；使高兴
caprice|n. 反复无常；任性；怪想
satiation|n. 饱食；饱满；饱享；厌腻
frantically|adv. 疯狂地；狂热地
avenge|v. 报（某事）之仇；为（某人）报仇
boredom|n. 无聊；厌倦；厌烦
clatter|n. 咔嗒声；哗啦声；嘈杂的谈笑声；v. （使）发出哗啦声；咔嗒咔嗒响；喧闹地谈笑
appetite|n. 胃口；食欲；嗜好；爱好
grudge|n. 怨恨；积怨；嫌隙；v. 勉强做；不情愿地给；吝惜
absorbing|adj. 吸引人的；非常有趣的；v. 吸收；吸引；“absorb”的现在分词
banish|v. 驱逐；消除
assumption|n. 假设；假想
manoeuvre|n. （熟练地）移动；巧计；v. 控制；移动；操控
myriad|n. 无数；大量；adj. 无数的；多种的
paradox|n. 悖论；矛盾
cynic|n. 愤世嫉俗者；悲观者；怀疑者
sociologist|n. 社会学家；社会学者
shun|v. 避开；避免
affluent|adj. 富裕的；丰富的；富足的
chambermaid|n. （打扫宾馆客房的）女服务员
boo|int. 呸；嘘；n. 嘘声；v. 发出嘘声
maître d'hôtel|phrase. 餐厅领班；酒店总管
snobbery|n. 势利态度（或行为）
hierarchy|n. 层次体系；等级制度
entail|v. 需要；使…必然发生
inclement|adj. （天气）恶劣的
package tour|phrase. 包办旅行
insularity|n. 岛国；孤立；偏狭
cater|v. 迎合；满足需要；供应酒菜
exclusively|adv. 排外地；专有地
cosmopolitan|adj. 全世界的；四海一家的；n. 世界主义者；四海为家者
preponderance|n. 优势；多数
overwhelmingly|adv. 压倒性地；不可抵抗地
patronage|n. 赞助；惠顾；委任权
sauerkraut|n. （酸）泡菜；德国泡菜
vie|v. 竞争；争夺
municipality|n. 自治市；市当局
itinerant|adj. 巡回的；流动的；n. 四处奔波的人；流浪者
heath|n. 荒地；石南
alienate|v. 使疏远；离间；让渡
eternal|adj. 不朽的；永久的
portfolio|n. 文件夹；公事包；作品集；部长职务；投资组合
tipster|n. 情报贩子；密报者
Las Vegas|n. 拉斯维加斯
fritter|n. 油炸馅饼；v. 挥霍；浪费
reputable|adj. 有声望的；声誉好的
broker|n. 经纪人；掮客；v. 安排协商
finance|n. 金融；财务；v. 提供资金
mortgage|n. 抵押；按揭；v. 抵押；按揭
pension|n. 养老金；退休金；抚恤金
priority|n. 优先权；需优先考虑的事
gilt|adj. 镀金的；烫金的；v. 给…镀金；涂金于…；“gild”的过去式和过去分词；n. 镀金部分；金边证券
convertible|adj. 可自由兑换的（货币）；可改变的；可转换的；n. 敞篷车；可换证券
sanguine|adj. 乐天的；自信的；红润的
heady|adj. 兴奋的；陶醉的；飘飘然的；任性的
alongside|prep. 在…旁边；与…一起；adv. 在…的侧面；与…并排
pedestrian|n. 行人；步行者；adj. 步行的；呆板的；平淡无奇的